The ringing of your alarm clock wakes you up. You get out of bed to find that none of your fellow crew members are in the crew's quarters. They probably just went to breakfast. You had hoped for a cushy engineering job on Earth, but the UNSA had other plans for your career. It's been two years since you were assigned to this ship, and your team hasn't been able to find any sign of alien life in the cosmos. As you change from your pajamas into your uniform, you hear a loud voice booming from the intercom.

Houston, We Have a Problem
An Interactive Fiction by Leo Kodish
Release 1 / Serial number 140311 / Inform 7 build 6G60 (I6/v6.32 lib 6/12N) SD

Crew's Quarters
This is the room you have shared with your fellow astronauts for the last two years. The room is large enough to fit the twenty or so beds needed to accommodate all of the astronauts on the ship. You don't have a bedside desk or anything like that, so you've had to keep your things under your bed. 
The Maintenance Room is to your west.

>w
Maintenance Room
The room that holds the engine of the space ship. The lights are flashing red, giving the impression that something might have gone wrong with the engine. 
The Crew's Quarters are to the East. The Mess Hall is to the North, and the Observation Deck is to the West.

ATTENTION! This is an emergency UNSA broadcast. Most of your crewmates have safely evacuated the ship on escape pods, but if anyone is still aboard this ship, your engine has malfunctioned, and will explode unless it is fixed. We have sent a rescue team to save any crew members who may still be aboard the ship, but we predict the engine to explode before we can reach you, so you must fix the engine in order to give us enough time to save you.

>w
Observation Deck
This is a room in the ship where people go to relax. It has some comfortable sofas for people to sit on, and they face a large plate of glass that acts as a window. If you look through the window, you can see the wing of the spaceship, as well as the infinite cosmos you have been traveled through for the last two years. 
The Medical Bay is to the West. The Airlock is to the North. The Command Room is to the South, and the Maintenance Room is to the East.

>n
Airlock
This is the Airlock. The room where the astronauts on the ship must go through in order to enter space. The airlock door to the North leads to the wing of the spaceship. 
The Observation Deck is to the South.

You can see an Airlock Door and an oxygen tank here.

>open airlock door
fdsfd
You open the airlock door and step out into space, but you suffocate without any oxygen to breathe.

    *** You have died ***

Would you like to RESTART, RESTORE a saved game, QUIT or UNDO the last command?

* * *

>n
Airlock
This is the Airlock. The room where the astronauts on the ship must go through in order to enter space. The airlock door to the North leads to the wing of the spaceship. 
The Observation Deck is to the South.

You can see an Airlock Door and an oxygen tank here.

>n
(first opening the Airlock Door)
You open the airlock door and step out into space, but you suffocate without any oxygen to breathe.

    *** You have died ***

Would you like to RESTART, RESTORE a saved game, QUIT or UNDO the last command?

>undo
Airlock
[Previous turn undone.]

>s
Observation Deck
This is a room in the ship where people go to relax. It has some comfortable sofas for people to sit on, and they face a large plate of glass that acts as a window. If you look through the window, you can see the wing of the spaceship, as well as the infinite cosmos you have been traveled through for the last two years. 
The Medical Bay is to the West. The Airlock is to the North. The Command Room is to the South, and the Maintenance Room is to the East.

>w
Medical Bay
A room that is used to treat any injuries that the astronauts may have while on the ship. Most of the equipment in the room appears to have been taken by the evacuated crew members. You see a storage locker used by to hold chemicals and medical equipment. 
The Observation Deck is to the East.

>open locker
It appears that the most of the medicine and equipment has been taken, but you can see a scalpel and medical tubing that have been left behind.

>take scalpel
Taken.

* * *

>w
Observation Deck
This is a room in the ship where people go to relax. It has some comfortable sofas for people to sit on, and they face a large plate of glass that acts as a window. If you look through the window, you can see the wing of the spaceship, as well as the infinite cosmos you have been traveled through for the last two years. 
The Medical Bay is to the West. The Airlock is to the North. The Command Room is to the South, and the Maintenance Room is to the East.

>s
Command Room
It is a room that was used by the main security officer to watch over the ship. They are television monitors on the walls that he used to observe the rooms on the ship You can also see the desk the officer would sit in to observe the monitors. 
The Observation Deck is to the North.

>n
Observation Deck
This is a room in the ship where people go to relax. It has some comfortable sofas for people to sit on, and they face a large plate of glass that acts as a window. If you look through the window, you can see the wing of the spaceship, as well as the infinite cosmos you have been traveled through for the last two years. 
The Medical Bay is to the West. The Airlock is to the North. The Command Room is to the South, and the Maintenance Room is to the East.

>w
Medical Bay
A room that is used to treat any injuries that the astronauts may have while on the ship. Most of the equipment in the room appears to have been taken by the evacuated crew members. You see a storage locker used by to hold chemicals and medical equipment. 
The Observation Deck is to the East.

* * *

>take scalpel
Taken.

>e
Observation Deck
This is a room in the ship where people go to relax. It has some comfortable sofas for people to sit on, and they face a large plate of glass that acts as a window. If you look through the window, you can see the wing of the spaceship, as well as the infinite cosmos you have been traveled through for the last two years. 
The Medical Bay is to the West. The Airlock is to the North. The Command Room is to the South, and the Maintenance Room is to the East.

>e
Maintenance Room
The room that holds the engine of the space ship. The lights are flashing red, giving the impression that something might have gone wrong with the engine. 
The Crew's Quarters are to the East. The Mess Hall is to the North, and the Observation Deck is to the West.

>n
Mess Hall
This is the room where the astronauts eat their meals. There are long table for eating, similar to what you would see in a school cafeteria. It's around breakfast time, so this room should be bustling with hungry crew members, but they've all left the ship. You thought you were the only person left on the ship, but you see a very hungry looking astronaut sitting down at one of the tables. 
The Kitchen is to the North

You can see a kitchen door and an Astronaut here.

>lockpick door
You use the scalpel to lockpick the door. You hear a click, and the door opens.

>n
(first opening the kitchen door)

Kitchen
The room where the head chef aboard the ship would prepare all of the meals for the crew members. It appears that most of the food and supplies have been taken by the crew members who left on the escape pods. You can see the refrigerator where the chef would keep all of his ingredients. 
The Mess Hall is to the South.

You can see a kitchen door here.

>open fridge
You open the refrigerator, revealing a sandwich.

>take sand
You can't see any such thing.

>take sandwich
Taken.

>s
Mess Hall
This is the room where the astronauts eat their meals. There are long table for eating, similar to what you would see in a school cafeteria. It's around breakfast time, so this room should be bustling with hungry crew members, but they've all left the ship. You thought you were the only person left on the ship, but you see a very hungry looking astronaut sitting down at one of the tables. 
The Kitchen is to the North

You can see a kitchen door and an Astronaut here.

>give sandwich
(to the Astronaut)
The astronaut gratefully accepts the sandwich, and begins eating. He finishes the sandwich in just a few seconds.

>talk to astronaut
Thank you so much. I thought I was going to starve for a second. I guess I owe you a spacesuit. Here you go: 

He offers you his space suit.

>take space suit
Taken.

>s
Maintenance Room
The room that holds the engine of the space ship. The lights are flashing red, giving the impression that something might have gone wrong with the engine. 
The Crew's Quarters are to the East. The Mess Hall is to the North, and the Observation Deck is to the West.

>wear space suit
You put on the space suit.

>w
Observation Deck
This is a room in the ship where people go to relax. It has some comfortable sofas for people to sit on, and they face a large plate of glass that acts as a window. If you look through the window, you can see the wing of the spaceship, as well as the infinite cosmos you have been traveled through for the last two years. 
The Medical Bay is to the West. The Airlock is to the North. The Command Room is to the South, and the Maintenance Room is to the East.

* * *

>n
Airlock
This is the Airlock. The room where the astronauts on the ship must go through in order to enter space. The airlock door to the North leads to the wing of the spaceship. 
The Observation Deck is to the South.

You can see an Airlock Door and an oxygen tank here.

>open airlock door
You open the airlock door and step out into space, but you suffocate without any oxygen to breathe.

    *** You have died ***

Would you like to RESTART, RESTORE a saved game, QUIT or UNDO the last command?

>undo
Airlock
[Previous turn undone.]

>take oxygen tank
Taken.

>combine oxygen tank
What do you want to combine the oxygen tank with?

>space suit
You now have an oxygen enhanced space suit.

>wear space suit
You put on the oxygen enhanced space suit.

>open airlock
wing
You step through the airlock door and onto the wing of the spaceship. Even after spending two years flying through space, the wing is just as sleek and white as the day the ship blasted off from Earth. There is a small detachable antenna coming out of the wing.

A small metal antenna that you found on the wing of the spaceship.

You can also see an Airlock Door here.

>open airlock door
That's already open.

>close airlock door
You close the Airlock Door.

>s
(first opening the Airlock Door)
wing
You step through the airlock door and onto the wing of the spaceship. Even after spending two years flying through space, the wing is just as sleek and white as the day the ship blasted off from Earth. There is a small detachable antenna coming out of the wing.

A small metal antenna that you found on the wing of the spaceship.

You can also see an Airlock Door here.

Airlock
This is the Airlock. The room where the astronauts on the ship must go through in order to enter space. The airlock door to the North leads to the wing of the spaceship. 
The Observation Deck is to the South.

You can see an Airlock Door here.

>open airlock door
That's already open.

* * *

>close airlock door
You close the Airlock Door.

>open airlock door
wing
You step through the airlock door and onto the wing of the spaceship. Even after spending two years flying through space, the wing is just as sleek and white as the day the ship blasted off from Earth. There is a small detachable antenna coming out of the wing.

A small metal antenna that you found on the wing of the spaceship.

You can also see an Airlock Door here.

>take antenna
Taken.

>s
Airlock
This is the Airlock. The room where the astronauts on the ship must go through in order to enter space. The airlock door to the North leads to the wing of the spaceship. 
The Observation Deck is to the South.

You can see an Airlock Door here.

>s
Observation Deck
This is a room in the ship where people go to relax. It has some comfortable sofas for people to sit on, and they face a large plate of glass that acts as a window. If you look through the window, you can see the wing of the spaceship, as well as the infinite cosmos you have been traveled through for the last two years. 
The Medical Bay is to the West. The Airlock is to the North. The Command Room is to the South, and the Maintenance Room is to the East.

>e
Maintenance Room
The room that holds the engine of the space ship. The lights are flashing red, giving the impression that something might have gone wrong with the engine. 
The Crew's Quarters are to the East. The Mess Hall is to the North, and the Observation Deck is to the West.

>w
Observation Deck
This is a room in the ship where people go to relax. It has some comfortable sofas for people to sit on, and they face a large plate of glass that acts as a window. If you look through the window, you can see the wing of the spaceship, as well as the infinite cosmos you have been traveled through for the last two years. 
The Medical Bay is to the West. The Airlock is to the North. The Command Room is to the South, and the Maintenance Room is to the East.

>e
Maintenance Room
The room that holds the engine of the space ship. The lights are flashing red, giving the impression that something might have gone wrong with the engine. 
The Crew's Quarters are to the East. The Mess Hall is to the North, and the Observation Deck is to the West.

* * *

>w
Observation Deck
This is a room in the ship where people go to relax. It has some comfortable sofas for people to sit on, and they face a large plate of glass that acts as a window. If you look through the window, you can see the wing of the spaceship, as well as the infinite cosmos you have been traveled through for the last two years. 
The Medical Bay is to the West. The Airlock is to the North. The Command Room is to the South, and the Maintenance Room is to the East.

* * *

>s
Command Room
It is a room that was used by the main security officer to watch over the ship. They are television monitors on the walls that he used to observe the rooms on the ship You can also see the desk the officer would sit in to observe the monitors. 
The Observation Deck is to the North.

>open drawer
It doesn't look like the security officer kept much in here, but you do see a wrench in the drawer.

>take wrench
Taken.

>undo
Command Room
[Previous turn undone.]

>take wrench
Taken.

>n
Observation Deck
This is a room in the ship where people go to relax. It has some comfortable sofas for people to sit on, and they face a large plate of glass that acts as a window. If you look through the window, you can see the wing of the spaceship, as well as the infinite cosmos you have been traveled through for the last two years. 
The Medical Bay is to the West. The Airlock is to the North. The Command Room is to the South, and the Maintenance Room is to the East.

>e
Maintenance Room
The room that holds the engine of the space ship. The lights are flashing red, giving the impression that something might have gone wrong with the engine. 
The Crew's Quarters are to the East. The Mess Hall is to the North, and the Observation Deck is to the West.

>fix engine
Using the wrench and antenna, you repair the broken nitrogen compressor. The lights in the room have stopped flashing red, and you hear a voice come over the intercom. 
ATTENTION! This is another UNSA broadcast. We have received a signal from your ship that your engine has been repaired and is no longer in any danger of exploding. Our rescue ships should now have enough time to reach you.

    *** You have won ***

Would you like to RESTART, RESTORE a saved game, QUIT or UNDO the last command?

* * *

>s
Command Room
It is a room that was used by the main security officer to watch over the ship. They are television monitors on the walls that he used to observe the rooms on the ship You can also see the desk the officer would sit in to observe the monitors. 
The Observation Deck is to the North.

>x monitors
The monitors are showing the command room. You can see yourself as you stare at the monitors.

The monitors are showing the command room. You can see yourself as you stare at the monitors, you also notice a book you didn't notice before behind the security officer's desk.

* * *

>w
Observation Deck
This is a room in the ship where people go to relax. It has some comfortable sofas for people to sit on, and they face a large plate of glass that acts as a window. If you look through the window, you can see the wing of the spaceship, as well as the infinite cosmos you have been traveled through for the last two years. 
The Medical Bay is to the West. The Airlock is to the North. The Command Room is to the South, and the Maintenance Room is to the East.

>w
Medical Bay
A room that is used to treat any injuries that the astronauts may have while on the ship. Most of the equipment in the room appears to have been taken by the evacuated crew members. 
The Observation Deck is to the East.

You can see a scalpel here.

>take scalpel
Taken.

* * *

>lockpick door
You use the scalpel to lockpick the door. You hear a click, and the door opens.

>n
(first opening the kitchen door)

Kitchen
The room where the head chef aboard the ship would prepare all of the meals for the crew members. It appears that the crew members who left on the escape pods have taken most of the food and supplies. You can see the refrigerator where the chef would keep all of his ingredients. 
The Mess Hall is to the South.

You can see a kitchen door here.

>open fridge
You open the refrigerator, revealing a sandwich.

>take sandwich
Taken.

>take all
There are none at all available!

>e
You can't go that way.

>s
Mess Hall
This is the room where the astronauts eat their meals. There are long table for eating, similar to what you would see in a school cafeteria. It's around breakfast time, so this room should be bustling with hungry crew members, but they've all left the ship. You thought you were the only person left on the ship, but you see a very hungry looking astronaut sitting down at one of the tables. 
The Kitchen is to the North

You can see a kitchen door and an Astronaut here.

>take all
There are none at all available!

>give sandwich
(to the Astronaut)
The astronaut gratefully accepts the sandwich, and begins eating. He finishes the sandwich in just a few seconds.

* * *

>s
Maintenance Room
The room that holds the engine of the space ship. The lights are flashing red, giving the impression that something might have gone wrong with the engine. 
The Crew's Quarters are to the East. The Mess Hall is to the North, and the Observation Deck is to the West.

>w
Observation Deck
This is a room in the ship where people go to relax. It has some comfortable sofas for people to sit on, and they face a large plate of glass that acts as a window. If you look through the window, you can see the wing of the spaceship, as well as the infinite cosmos you have been traveled through for the last two years. 
The Medical Bay is to the West. The Airlock is to the North. The Command Room is to the South, and the Maintenance Room is to the East.

* * *

>n
Airlock
This is the Airlock. The room where the astronauts on the ship must go through in order to enter space. The airlock door to the North leads to the wing of the spaceship. 
The Observation Deck is to the South.

You can see an Airlock Door and an oxygen tank here.

>take tank
Taken.

>combine tank with suit
You now have an oxygen enhanced space suit.

>wear suit
You put on the oxygen enhanced space suit.

>n
(first opening the Airlock Door)
wing
You step through the airlock door and onto the wing of the spaceship. Even after spending two years flying through space, the wing is just as sleek and white as the day the ship blasted off from Earth. There is a small detachable antenna coming out of the wing.

A small metal antenna that you found on the wing of the spaceship.

You can also see an Airlock Door here.

wing
You step through the airlock door and onto the wing of the spaceship. Even after spending two years flying through space, the wing is just as sleek and white as the day the ship blasted off from Earth. There is a small detachable antenna coming out of the wing.

A small metal antenna that you found on the wing of the spaceship.

You can also see an Airlock Door here.

>s
Airlock
This is the Airlock. The room where the astronauts on the ship must go through in order to enter space. The airlock door to the North leads to the wing of the spaceship. 
The Observation Deck is to the South.

You can see an Airlock Door here.

>n
wing
You step through the airlock door and onto the wing of the spaceship. Even after spending two years flying through space, the wing is just as sleek and white as the day the ship blasted off from Earth. There is a small detachable antenna coming out of the wing.

A small metal antenna that you found on the wing of the spaceship.

You can also see an Airlock Door here.

* * *

>s
Mess Hall
This is the room where the astronauts eat their meals. There are long table for eating, similar to what you would see in a school cafeteria. It's around breakfast time, so this room should be bustling with hungry crew members, but they've all left the ship. You thought you were the only person left on the ship, but you see a very hungry looking astronaut sitting down at one of the tables. 
The Kitchen is to the North

You can see a kitchen door and an Astronaut here.

>talk to astronaut
I'm so hungry! Please, just give me some food. I would do anything. I would even give you my space suit if you just brought me some food.

>give sandwich
(to the Astronaut)
The astronaut gratefully accepts the sandwich, and begins eating. He finishes the sandwich in just a few seconds.

>talk to astronaut
Thank you so much. I thought I was going to starve for a second. I guess I owe you a spacesuit. Here you go: 

He gives you his space suit.

>take space suit
You already have that.

* * *

>n
Mess Hall
This is the room where the astronauts eat their meals. There are long table for eating, similar to what you would see in a school cafeteria. It's around breakfast time, so this room should be bustling with hungry crew members, but they've all left the ship. You thought you were the only person left on the ship, but you see a very hungry looking astronaut sitting down at one of the tables. 
The Kitchen is to the North

You can see a kitchen door and an Astronaut here.

>s
Maintenance Room
The room that holds the engine of the space ship. The lights are flashing red, giving the impression that something might have gone wrong with the engine. 
The Crew's Quarters are to the East. The Mess Hall is to the North, and the Observation Deck is to the West.

* * *

>give sandwich
(to the Astronaut)
The astronaut gratefully accepts the sandwich, and begins eating. He finishes the sandwich in just a few seconds.

>s
Maintenance Room
The room that holds the engine of the space ship. The lights are flashing red, giving the impression that something might have gone wrong with the engine. 
The Crew's Quarters are to the East. The Mess Hall is to the North, and the Observation Deck is to the West.

>n
Mess Hall
This is the room where the astronauts eat their meals. There are long table for eating, similar to what you would see in a school cafeteria. It's around breakfast time, so this room should be bustling with hungry crew members, but they've all left the ship. You thought you were the only person left on the ship, but you see a very hungry looking astronaut sitting down at one of the tables. 
The Kitchen is to the North

You can see a kitchen door and an Astronaut here.

>give sandwich
You can't see any such thing.

* * *

>s
You can't go that way.

>n
Mess Hall
This is the room where the astronauts eat their meals. There are long table for eating, similar to what you would see in a school cafeteria. It's around breakfast time, so this room should be bustling with hungry crew members, but they've all left the ship. You thought you were the only person left on the ship, but you see a very hungry looking astronaut sitting down at one of the tables. 
The Kitchen is to the North

You can see a kitchen door and an Astronaut here.

* * *

>e
Observation Deck
This is a room in the ship where people go to relax. It has some comfortable sofas for people to sit on, and they face a large plate of glass that acts as a window. If you look through the window, you can see the wing of the spaceship, as well as the infinite cosmos you have been traveled through for the last two years. 
The Medical Bay is to the West. The Airlock is to the North. The Command Room is to the South, and the Maintenance Room is to the East.

I beg your pardon?

>e
Maintenance Room
The room that holds the engine of the space ship. The lights are flashing red, giving the impression that something might have gone wrong with the engine. 
The Crew's Quarters are to the East. The Mess Hall is to the North, and the Observation Deck is to the West.

* * *

>s
Mess Hall
This is the room where the astronauts eat their meals. There are long table for eating, similar to what you would see in a school cafeteria. It's around breakfast time, so this room should be bustling with hungry crew members, but they've all left the ship. You thought you were the only person left on the ship, but you see a very hungry looking astronaut sitting down at one of the tables. 
The Kitchen is to the North

You can see a kitchen door and an Astronaut here.

>give sandwich to astronaut
The astronaut gratefully accepts the sandwich, and begins eating. He finishes the sandwich in just a few seconds.

>talk to astronaut
Thank you so much. I thought I was going to starve for a second. I guess I owe you a spacesuit. Here you go: 

He offers you his space suit.

* * *

>take space suit
Taken.

>wear space suit
You put on the space suit.

>s
Maintenance Room
The room that holds the engine of the space ship. The lights are flashing red, giving the impression that something might have gone wrong with the engine. 
The Crew's Quarters are to the East. The Mess Hall is to the North, and the Observation Deck is to the West.

* * *

>w
Observation Deck
This is a room in the ship where people go to relax. It has some comfortable sofas for people to sit on, and they face a large plate of glass that acts as a window. If you look through the window, you can see the wing of the spaceship, as well as the infinite cosmos you have been traveled through for the last two years. 
The Medical Bay is to the West. The Airlock is to the North. The Command Room is to the South, and the Maintenance Room is to the East.

>n
Airlock
This is the Airlock. The room the astronauts on the ship must go through in order to enter space. The airlock door to the North leads to the wing of the spaceship. 
The Observation Deck is to the South.

You can see an Airlock Door and an oxygen tank here.

>n
(first opening the Airlock Door)
You open the airlock door and step out into space, but you suffocate without any oxygen to breathe.

    *** You have died ***

Would you like to RESTART, RESTORE a saved game, QUIT or UNDO the last command?

* * *

>undo
Airlock
[Previous turn undone.]

>undo
Observation Deck
[Previous turn undone.]

>n
Airlock
This is the Airlock. The room the astronauts on the ship must go through in order to enter space. The airlock door to the North leads to the wing of the spaceship. 
The Observation Deck is to the South.

You can see an Airlock Door and an oxygen tank here.

>combine tank with suit
(first taking the oxygen tank)
You now have an oxygen enhanced space suit.

>inv
You are carrying:
  an oxygen enhanced space suit
  a scalpel

>wear oxygen enhanced space suit
You put on the oxygen enhanced space suit.

>x me
You are dressed in your UNSA engineers uniform. You have grown quite a long beard after being on this ship for two years without a razor or shaving cream.

>inv
You are carrying:
  an oxygen enhanced space suit (being worn)
  a scalpel

>n
(first opening the Airlock Door)
wing
You step through the airlock door and onto the wing of the spaceship. Even after spending two years flying through space, the wing is just as sleek and white as the day the ship blasted off from Earth. There is a small detachable antenna coming out of the wing.

You can see an Airlock Door and an antenna here.

wing
You step through the airlock door and onto the wing of the spaceship. Even after spending two years flying through space, the wing is just as sleek and white as the day the ship blasted off from Earth. There is a small detachable antenna coming out of the wing.

You can see an Airlock Door and an antenna here.

>s
Airlock
This is the Airlock. The room the astronauts on the ship must go through in order to enter space. The airlock door to the North leads to the wing of the spaceship. 
The Observation Deck is to the South.

You can see an Airlock Door here.

>n
wing
You step through the airlock door and onto the wing of the spaceship. Even after spending two years flying through space, the wing is just as sleek and white as the day the ship blasted off from Earth. There is a small detachable antenna coming out of the wing.

You can see an Airlock Door and an antenna here.

>s
Airlock
This is the Airlock. The room the astronauts on the ship must go through in order to enter space. The airlock door to the North leads to the wing of the spaceship. 
The Observation Deck is to the South.

You can see an Airlock Door here.

* * *

>n
wing
You step through the airlock door and onto the wing of the spaceship. Even after spending two years flying through space, the wing is just as sleek and white as the day the ship blasted off from Earth. There is a small detachable antenna coming out of the wing.

You can see an Airlock Door and an antenna here.

>undo
Airlock
[Previous turn undone.]

>undo
wing
[Previous turn undone.]

>undo
Airlock
[Previous turn undone.]

>undo
"Undo" failed.  [Not all interpreters provide it.]

>l
Airlock
This is the Airlock. The room the astronauts on the ship must go through in order to enter space. The airlock door to the North leads to the wing of the spaceship. 
The Observation Deck is to the South.

You can see an Airlock Door here.

>n
(first opening the Airlock Door)
wing
You step through the airlock door and onto the wing of the spaceship. Even after spending two years flying through space, the wing is just as sleek and white as the day the ship blasted off from Earth. There is a small detachable antenna coming out of the wing.

You can see an Airlock Door and an antenna here.

wing
You step through the airlock door and onto the wing of the spaceship. Even after spending two years flying through space, the wing is just as sleek and white as the day the ship blasted off from Earth. There is a small detachable antenna coming out of the wing.

You can see an Airlock Door and an antenna here.

>undo
Airlock
[Previous turn undone.]

>n
(first opening the Airlock Door)
wing
You step through the airlock door and onto the wing of the spaceship. Even after spending two years flying through space, the wing is just as sleek and white as the day the ship blasted off from Earth. There is a small detachable antenna coming out of the wing.

You can see an Airlock Door and an antenna here.

wing
You step through the airlock door and onto the wing of the spaceship. Even after spending two years flying through space, the wing is just as sleek and white as the day the ship blasted off from Earth. There is a small detachable antenna coming out of the wing.

You can see an Airlock Door and an antenna here.

* * *

>undo
Airlock
[Previous turn undone.]

>l
Airlock
This is the Airlock. The room the astronauts on the ship must go through in order to enter space. The airlock door to the North leads to the wing of the spaceship. 
The Observation Deck is to the South.

You can see an Airlock Door here.

* * *

>undo
Airlock
[Previous turn undone.]

>undo
Airlock
[Previous turn undone.]

* * *

>x ground
You can't see any such thing.

>s
Airlock
This is the Airlock. The room the astronauts on the ship must go through in order to enter space. The airlock door to the North leads to the wing of the spaceship. 
The Observation Deck is to the South.

You can see an Airlock Door here.

* * *

>ww
That's not a verb I recognise.

>ww
That's not a verb I recognise.

>w
Maintenance Room
The room that holds the engine of the space ship. The lights are flashing red, giving the impression that something might have gone wrong with the engine. 
The Crew's Quarters are to the East. The Mess Hall is to the North, and the Observation Deck is to the West.

ATTENTION! This is an emergency UNSA broadcast. Most of your crewmates have safely evacuated the ship on escape pods, but if anyone is still aboard this ship, your engine has malfunctioned, and will explode unless it is fixed. We have sent a rescue team to save any crew members who may still be aboard the ship, but we predict the engine to explode before we can reach you, so you must fix the engine in order to give us enough time to save you.

* * *

>talk to astronaut
Thank you so much. I thought I was going to starve for a second. I guess I owe you a spacesuit. Here you go: 

He offers you his space suit.

>take suit
Taken.

>e
You can't go that way.

>s
Maintenance Room
The room that holds the engine of the space ship. The lights are flashing red, giving the impression that something might have gone wrong with the engine. 
The Crew's Quarters are to the East. The Mess Hall is to the North, and the Observation Deck is to the West.

* * *

>w
Observation Deck
This is a room in the ship where people go to relax. It has some comfortable sofas for people to sit on, and they face a large plate of glass that acts as a window. If you look through the window, you can see the wing of the spaceship, as well as the infinite cosmos you have been traveled through for the last two years. 
The Medical Bay is to the West. The Airlock is to the North. The Command Room is to the South, and the Maintenance Room is to the East.

I beg your pardon?

>n
Airlock
This is the Airlock. The room the astronauts on the ship must go through in order to enter space. The airlock door to the North leads to the wing of the spaceship. 
The Observation Deck is to the South.

You can see an Airlock Door and an oxygen tank here.

* * *

>combine tank with suit
(first taking the oxygen tank)
You now have an oxygen enhanced space suit.

>wear suit
You put on the oxygen enhanced space suit.

>open airlock door
Wing
You step through the airlock door and onto the wing of the spaceship. Even after spending two years flying through space, the wing is just as sleek and white as the day the ship blasted off from Earth. There is a small detachable antenna coming out of the wing.

You can see an Airlock Door and an antenna here.

>take antenna
Taken.

>s
Airlock
This is the Airlock. The room the astronauts on the ship must go through in order to enter space. The airlock door to the North leads to the wing of the spaceship. 
The Observation Deck is to the South.

You can see an Airlock Door here.

>n
Wing
You step through the airlock door and onto the wing of the spaceship. Even after spending two years flying through space, the wing is just as sleek and white as the day the ship blasted off from Earth. There is a small detachable antenna coming out of the wing.

You can see an Airlock Door here.

>s
Airlock
This is the Airlock. The room the astronauts on the ship must go through in order to enter space. The airlock door to the North leads to the wing of the spaceship. 
The Observation Deck is to the South.

You can see an Airlock Door here.

* * *

>n
Wing
You step through the airlock door and onto the wing of the spaceship. Even after spending two years flying through space, the wing is just as sleek and white as the day the ship blasted off from Earth. There is a small detachable antenna coming out of the wing.

You can see an Airlock Door here.

>take antenna
You already have that.

>s
Airlock
This is the Airlock. The room the astronauts on the ship must go through in order to enter space. The airlock door to the North leads to the wing of the spaceship. 
The Observation Deck is to the South.

You can see an Airlock Door here.

>s
Observation Deck
This is a room in the ship where people go to relax. It has some comfortable sofas for people to sit on, and they face a large plate of glass that acts as a window. If you look through the window, you can see the wing of the spaceship, as well as the infinite cosmos you have been traveled through for the last two years. 
The Medical Bay is to the West. The Airlock is to the North. The Command Room is to the South, and the Maintenance Room is to the East.

>s
Command Room
It is a room that was used by the main security officer to watch over the ship. They are television monitors on the walls that he used to observe the rooms on the ship You can also see the desk the officer would sit in to observe the monitors. 
The Observation Deck is to the North.

* * *

>x monitors
The monitors are showing the command room. You can see yourself as you stare at the monitors.

The monitors are showing the command room. You can see yourself as you stare at the monitors, you also notice a book you didn't notice before behind the security officer's desk.

>take book
Taken.

>open desk
It doesn't look like the security officer kept much in here, but you do see a wrench in the drawer.

>take wrench
Taken.

* * *

>e
Maintenance Room
The room that holds the engine of the space ship. The lights are flashing red, giving the impression that something might have gone wrong with the engine. 
The Crew's Quarters are to the East. The Mess Hall is to the North, and the Observation Deck is to the West.

>e
Crew's Quarters
This is the room you have shared with your fellow astronauts for the last two years. The room is large enough to fit the twenty or so beds needed to accommodate all of the astronauts on the ship. You don't have a bedside desk or anything like that, so you've had to keep your things under your bed. 
The Maintenance Room is to your west.

>look under bed
You find the Auto-Mechanic you keep under your bed.

>take auto
Taken.

>use auto
That's not a verb I recognise.

* * *

>w
Maintenance Room
The room that holds the engine of the space ship. The lights are flashing red, giving the impression that something might have gone wrong with the engine. 
The Crew's Quarters are to the East. The Mess Hall is to the North, and the Observation Deck is to the West.

>turn on auto
The engine debugger shows that there is engine is suffering from a broken nitrogen compressor. It says it can be fixed with a wrench, and an antenna.

>turn off auto
That's already off.

>turn on auto
The engine debugger shows that there is engine is suffering from a broken nitrogen compressor. It says it can be fixed with a wrench, and an antenna.

>turn on auto
The engine debugger shows that there is engine is suffering from a broken nitrogen compressor. It says it can be fixed with a wrench, and an antenna.

>e
Crew's Quarters
This is the room you have shared with your fellow astronauts for the last two years. The room is large enough to fit the twenty or so beds needed to accommodate all of the astronauts on the ship. You don't have a bedside desk or anything like that, so you've had to keep your things under your bed. 
The Maintenance Room is to your west.

* * *

>turn on auto
The engine debugger shows that there is engine is suffering from a broken nitrogen compressor. It says it can be fixed with a wrench, and an antenna.

>fix engine
Using the wrench and antenna, you repair the broken nitrogen compressor. The lights in the room have stopped flashing red, and you hear a voice come over the intercom. 
ATTENTION! This is another UNSA broadcast. We have received a signal from your ship that your engine has been repaired and is no longer in any danger of exploding. Our rescue ships should now have enough time to reach you.

    *** You have won ***

Would you like to RESTART, RESTORE a saved game, QUIT or UNDO the last command?

* * *

>look under bed
You find the Auto-Mechanic you keep under your bed.

* * *

>take auto
Taken.

>turn on auto
The auto-mechanic says it cannot debug anything for you since you are not in the presence of an engine.

>w
Maintenance Room
The room that holds the engine of the space ship. The lights are flashing red, giving the impression that something might have gone wrong with the engine. 
The Crew's Quarters are to the East. The Mess Hall is to the North, and the Observation Deck is to the West.

ATTENTION! This is an emergency UNSA broadcast. Most of your crewmates have safely evacuated the ship on escape pods, but if anyone is still aboard this ship, your engine has malfunctioned, and will explode unless it is fixed. We have sent a rescue team to save any crew members who may still be aboard the ship, but we predict the engine to explode before we can reach you, so you must fix the engine in order to give us enough time to save you.

>turn on auto
The auto-mechanic shows that there is engine is suffering from a broken nitrogen compressor. It says it can be fixed with a wrench, and an antenna.

>e
Crew's Quarters
This is the room you have shared with your fellow astronauts for the last two years. The room is large enough to fit the twenty or so beds needed to accommodate all of the astronauts on the ship. You don't have a bedside desk or anything like that, so you've had to keep your things under your bed. 
The Maintenance Room is to your west.

>turn on auto
The auto-mechanic says it cannot debug anything for you since you are not in the presence of an engine.

* * *

>w
Maintenance Room
The room that holds the engine of the space ship. The lights are flashing red, giving the impression that something might have gone wrong with the engine. 
The Crew's Quarters are to the East. The Mess Hall is to the North, and the Observation Deck is to the West.

ATTENTION! This is an emergency UNSA broadcast. Most of your crewmates have safely evacuated the ship on escape pods, but if anyone is still aboard this ship, your engine has malfunctioned, and will explode unless it is fixed. We have sent a rescue team to save any crew members who may still be aboard the ship, but we predict the engine to explode before we can reach you, so you must fix the engine in order to give us enough time to save you.

>turn on auto
The engine debugger shows that there is engine is suffering from a broken nitrogen compressor. It says it can be fixed with a wrench, and an antenna.

* * *

>w
Maintenance Room
The room that holds the engine of the space ship. The lights are flashing red, giving the impression that something might have gone wrong with the engine. 
The Crew's Quarters are to the East. The Mess Hall is to the North, and the Observation Deck is to the West.

>switch on auto
The engine debugger shows that there is engine is suffering from a broken nitrogen compressor. It says it can be fixed with a wrench, and an antenna.

>e
Crew's Quarters
This is the room you have shared with your fellow astronauts for the last two years. The room is large enough to fit the twenty or so beds needed to accommodate all of the astronauts on the ship. You don't have a bedside desk or anything like that, so you've had to keep your things under your bed. 
The Maintenance Room is to your west.

>switch on auto-debugger
You can't see any such thing.

>inv
You are carrying:
  an Auto-Mechanic

>switch on auto-mechanic
look under bed

* * *

>turn on auto
The auto-mechanic says it cannot debug anything for you since you are not in the presence of an engine.

>x auto
A device that when switched on, can be used to diagnose any problem that may occur with any type of engine, provided you are in the presence of an engine.

The Auto-Mechanic is currently switched off.

>turn on auto
The auto-mechanic says it cannot debug anything for you since you are not in the presence of an engine.

* * *

>x engine
A standard UNSA spaceship engine. It takes up most of the room due to its size. There is a large "United Nations Space Association" sticker placed in the middle of the engine.

>turn on auto mechanic
The auto-mechanic shows that there is engine is suffering from a broken nitrogen compressor. It says it can be fixed with a wrench, and an antenna.

>x engine
A standard UNSA spaceship engine. It takes up most of the room due to its size. There is a large "United Nations Space Association" sticker placed in the middle of the engine.

>turn on auto
The auto-mechanic shows that there is engine is suffering from a broken nitrogen compressor. It says it can be fixed with a wrench, and an antenna.

>n
Mess Hall
This is the room where the astronauts eat their meals. There are long table for eating, similar to what you would see in a school cafeteria. It's around breakfast time, so this room should be bustling with hungry crew members, but they've all left the ship. You thought you were the only person left on the ship, but you see a very hungry looking astronaut sitting down at one of the tables. 
The Kitchen is to the North

You can see a kitchen door and an Astronaut here.

>talk to astronaut
I'm so hungry! Please, just give me some food. I would do anything. I would even give you my space suit if you just brought me some food.

>open kitchen door
It seems to be locked.

>n
(first opening the kitchen door)
It seems to be locked.

>s
Maintenance Room
The room that holds the engine of the space ship. The lights are flashing red, giving the impression that something might have gone wrong with the engine. 
The Crew's Quarters are to the East. The Mess Hall is to the North, and the Observation Deck is to the West.

* * *

>w
Observation Deck
This is a room in the ship where people go to relax. It has some comfortable sofas for people to sit on, and they face a large plate of glass that acts as a window. If you look through the window, you can see the wing of the spaceship, as well as the infinite cosmos you have been traveled through for the last two years. 
The Medical Bay is to the West. The Airlock is to the North. The Command Room is to the South, and the Maintenance Room is to the East.

>look through window
You look through the window, staring out at the thousands of stars your ship passes by. You can see the wing of the spaceship, and you see an antenna planted on the wing.

>w
Medical Bay
A room that is used to treat any injuries that the astronauts may have while on the ship. Most of the equipment in the room appears to have been taken by the evacuated crew members. 
The Observation Deck is to the East.

You can see a scalpel here.

* * *

>e
Observation Deck
This is a room in the ship where people go to relax. It has some comfortable sofas for people to sit on, and they face a large plate of glass that acts as a window. If you look through the window, you can see the wing of the spaceship, as well as the infinite cosmos you have been traveled through for the last two years. 
The Medical Bay is to the West. The Airlock is to the North. The Command Room is to the South, and the Maintenance Room is to the East.

>s
Command Room
It is a room that was used by the main security officer to watch over the ship. They are television monitors on the walls that he used to observe the rooms on the ship You can also see the desk the officer would sit in to observe the monitors. 
The Observation Deck is to the North.

>x desk
a desk that the security officer would sit in while he observed the monitors. It has a drawer that the officer could put things in.

>open drawer
It doesn't look like the security officer kept much in here, but you do see a wrench in the drawer.

* * *

>take wrench
Taken.

>x wrench
A tool normally used for twisting nuts and bolts.

>l
Command Room
It is a room that was used by the main security officer to watch over the ship. They are television monitors on the walls that he used to observe the rooms on the ship You can also see the desk the officer would sit in to observe the monitors. 
The Observation Deck is to the North.

>x monitors
The monitors are showing the command room. You can see yourself as you stare at the monitors.

The monitors are showing the command room. You can see yourself as you stare at the monitors, you also notice a book you didn't notice before behind the security officer's desk.

>open desk
That's already open.

>close desk
You close the desk.

>open desk
The wrench was all you found in the drawer.

>take book
Taken.

>x book
A textbook on basic security. The security officer must read this in his spare time.

>read book
You flip to a page about lockpicking, and see that a scalpel can be used to unlock a locked door if you aren't in possession of a lockpick.

>n
Observation Deck
This is a room in the ship where people go to relax. It has some comfortable sofas for people to sit on, and they face a large plate of glass that acts as a window. If you look through the window, you can see the wing of the spaceship, as well as the infinite cosmos you have been traveled through for the last two years. 
The Medical Bay is to the West. The Airlock is to the North. The Command Room is to the South, and the Maintenance Room is to the East.

* * *

>n
Mess Hall
This is the room where the astronauts eat their meals. There are long table for eating, similar to what you would see in a school cafeteria. It's around breakfast time, so this room should be bustling with hungry crew members, but they've all left the ship. You thought you were the only person left on the ship, but you see a very hungry looking astronaut sitting down at one of the tables. 
The Kitchen is to the North

You can see a kitchen door and an Astronaut here.

>lock pick door
You can't see any such thing.

>lockpick door
You use the scalpel to lockpick the door. You hear a click, and the door opens.

>open door
You open the kitchen door.

* * *

>take auto
Taken.

>x auto mechanic
A device that when switched on, can be used to diagnose any problem that may occur with any type of engine, provided you are in the prescence of an engine.

The Auto-Mechanic is currently switched off.

>fix auto
That doesn't need to be fixed.

>x me
You are dressed in your UNSA engineers uniform. You have grown quite a long beard after being on this ship for two years without a razor or shaving cream.

>x player
You can't see any such thing.

* * *

I beg your pardon?

>w
Observation Deck
This is a room in the ship where people go to relax. It has some comfortable sofas for people to sit on, and they face a large plate of glass that acts as a window. If you look through the window, you can see the wing of the spaceship, as well as the infinite cosmos you have been traveled through for the last two years. 
The Medical Bay is to the West. The Airlock is to the North. The Command Room is to the South, and the Maintenance Room is to the East.

* * *

>e
You can't go that way.

>n
Observation Deck
This is a room in the ship where people go to relax. It has some comfortable sofas for people to sit on, and they face a large plate of glass that acts as a window. If you look through the window, you can see the wing of the spaceship, as well as the infinite cosmos you have been traveled through for the last two years. 
The Medical Bay is to the West. The Airlock is to the North. The Command Room is to the South, and the Maintenance Room is to the East.

* * *

>e
Maintenance Room
The room that holds the engine of the space ship. The lights are flashing red, giving the impression that something might have gone wrong with the engine. 
The Crew's Quarters are to the East. The Mess Hall is to the North, and the Observation Deck is to the West.

>turn on auto
The engine debugger shows that there is engine is suffering from a broken nitrogen compressor. It says it can be fixed with a wrench, and an antenna.

>n
Mess Hall
This is the room where the astronauts eat their meals. There are long table for eating, similar to what you would see in a school cafeteria. It's around breakfast time, so this room should be bustling with hungry crew members, but they've all left the ship. You thought you were the only person left on the ship, but you see a very hungry looking astronaut sitting down at one of the tables. 
The Kitchen is to the North

You can see a kitchen door and an Astronaut here.

* * *

>w
You can't go that way.

>w
You can't go that way.

>s
Maintenance Room
The room that holds the engine of the space ship. The lights are flashing red, giving the impression that something might have gone wrong with the engine. 
The Crew's Quarters are to the East. The Mess Hall is to the North, and the Observation Deck is to the West.

* * *

>n
Mess Hall
This is the room where the astronauts eat their meals. There are long table for eating, similar to what you would see in a school cafeteria. It's around breakfast time, so this room should be bustling with hungry crew members, but they've all left the ship. You thought you were the only person left on the ship, but you see a very hungry looking astronaut sitting down at one of the tables. 
The Kitchen is to the North

You can see a kitchen door and an Astronaut here.

>open door
It seems to be locked.

>unlock door
What do you want to unlock the kitchen door with?

>scalpel
You unlock the kitchen door.

>n
(first opening the kitchen door)

Kitchen
The room where the head chef aboard the ship would prepare all of the meals for the crew members. It appears that the crew members who left on the escape pods have taken most of the food and supplies. You can see the refrigerator where the chef would keep all of his ingredients. 
The Mess Hall is to the South.

You can see a kitchen door here.

* * *

>take space suit
You can't see any such thing.

* * *

>x auto
A device that when switched on, can be used to diagnose any problem that may occur with any type of engine, provided you are in the presence of an engine.

The Auto-Mechanic is currently switched off.

* * *

>x me
You are dressed in your UNSA engineers uniform. You have grown quite a long beard after being on this ship for two years without a razor or shaving cream.

* * *

>inv
You are carrying:
  a scalpel
  an Auto-Mechanic

>take space suit
You can't see any such thing.

>inv
You are carrying:
  a scalpel
  an Auto-Mechanic

* * *

>talk to astroaut
You can't see any such thing.

* * *

>look under bed
You find the Auto-Mechanic you keep under your bed.

>take fds
You can't see any such thing.

>take auto
Taken.

>undo
Crew's Quarters
[Previous turn undone.]