The ringing of your alarm clock wakes you up. You get out of bed to find that none of your fellow crew members are in the crew's quarters. They probably just went to breakfast. You had hoped for a cushy engineering job on Earth, but the UNSA had other plans for your career. It's been two years since you were assigned to this ship, and your team hasn't been able to find any sign of alien life in the cosmos. As you are changing from your pajamas into your uniform, you hear a loud voice booming from the intercom.

Houston, We Have a Problem
An Interactive Fiction by Leo Kodish
Release 1 / Serial number 140221 / Inform 7 build 6G60 (I6/v6.32 lib 6/12N) SD

Crew's Quarters
This is the room you have shared with your fellow astronauts for the last two years. The room is large enough to fit the twenty or so beds needed to accomodate all of the astronauts on the ship. You don't have a bedside desk or anything like that, so you've had to keep your reading material under your bed. The engine room is to your west.

>west
Maintenance Room
The room that holds the engine of the space ship. The lights are flashing red, giving the impression that something might have wrong.

I beg your pardon?

>eastw
That's not a verb I recognise.

>east
Crew's Quarters
This is the room you have shared with your fellow astronauts for the last two years. The room is large enough to fit the twenty or so bunks needed to accomodate all of the astronauts on the ship. You don't have a bedside desk or anything like that, so you've had to keep your reading material under your bed. The engine room is to your west.

>w
Maintenance Room
A room where the engine is located and maintained.

>e
Crew's Quarters
This is the room you have shared with your fellow astronauts for the last two years. The room is large enough to fit the twenty or so bunks needed to accomodate all of the astronauts on the ship. You don't have a bedside desk or anything like that, so you've had to keep your reading material under your bed. The engine room is to your west.

>w
Maintenance Room
A room where the engine is located and maintained.

I beg your pardon?

* * *

>west
Maintenance Room
The room that holds the engine of the space ship. The lights are flashing red, giving the impression that something might have wrong.

>x engine
A standard UNSA spaceship engine. It takes up most of the room due to its size. There is a large "United Nations Space Association" sticker placed on the center of the engine. Upon further examining the engine, you can see that the nitrogen compressor is broken.

>inv
You are carrying nothing.

* * *

>x engine
A standard UNSA spaceship engine. It takes up most of the room due to its size. There is a large "United Nations Space Association" sticker placed on the center of the engine. Upon further examining the engine, you can see that the nitrogen compressor is broken.

>open textbook
You can't see any such thing.

* * *

>west
Maintenance Room
The room that holds the engine of the space ship. The lights are flashing red, giving the impression that something might have wrong.

>w
observation deck
This is a room in the ship where people go to relax. It has some comfortable sofas for people to sit on, and they face a large plate of glass that acts as a window. If you look through the window, you can see the wing of the spaceship, as well as the infinite cosmos you have been traveled through for the last two years.

>w
You can't go that way.

* * *

>west
Maintenance Room
The room that holds the engine of the space ship. The lights are flashing red, giving the impression that something might have wrong.

>l
Maintenance Room
A room where the engine is located and maintained.

>east
Crew's Quarters
This is the room you have shared with your fellow astronauts for the last two years. The room is large enough to fit the twenty or so bunks needed to accomodate all of the astronauts on the ship. You don't have a bedside desk or anything like that, so you've had to keep your reading material under your bed. The engine room is to your west.

>west
Maintenance Room
A room where the engine is located and maintained.

* * *

>west
Maintenance Room
The room that holds the engine of the space ship. The lights are flashing red, giving the impression that something might have wrong.

>north
Mess Hall
This is the room where the astronauts eat their meals. There are long table for eating, similar to what you would see in a school cafeteria. It's around breakfast time, so this room should be bustling with hungry crew members, but they've all left the ship. You thought you were the only person left on the ship, but you see a very hungry looking astronaut sitting down at one of the tables.

An astronaut who is clutching his stomach. You can here it growling all the way from where you're standing. He's wearing a spacesuit, which would allow him to go outside of the ship if he needed to.

>south
Maintenance Room
The room that holds the engine of the space ship. The lights are flashing red, giving the impression that something might have wrong.

>west
You can't go that way.

* * *

>x bunk
Your bed

>look under bed
You find the ship maintenance textbook you had been reading before bed.

>l
Crew's Quarters
This is the room you have shared with your fellow astronauts for the last two years. The room is large enough to fit the twenty or so bunks needed to accomodate all of the astronauts on the ship. You don't have a bedside desk or anything like that, so you've had to keep your reading material under your bed. The engine room is to your west.

You can see a ship maintenance textbook (closed) here.

>take ship maintenance textbook
Taken.

>open textbook
You open the ship maintenance textbook.

>read textbook
It's a guide on how to fix any maintenance problem that may occur while on the space ship.

* * *

>l
Crew's Quarters
This is the room you have shared with your fellow astronauts for the last two years. The room is large enough to fit the twenty or so bunks needed to accomodate all of the astronauts on the ship. You don't have a bedside desk or anything like that, so you've had to keep your reading material under your bed. The engine room is to your west.

>west
Maintenance Room
A room where the engine is located and maintained.

>x engine
The engine is broken.

>inv
You are carrying:
  a ship maintenance textbook two (closed)

* * *

>x bumk
You can't see any such thing.

>x bunk
You can't see any such thing.

>x bed
A folding bed with an old mattress on it. It's similar to a standard military bed, with a metal headboard and bed frame.

>sleep in bed
I only understood you as far as wanting to sleep.

>sleep
You aren't feeling especially drowsy.

>x engine room
You can't see any such thing.

>look under bed
You find the ship maintenance textbook you had been reading before bed.

* * *

>take textbook
Taken.

>read textbook
It's a guide on how to fix any maintenance problem that may occur while on board the space ship.

>open textbook
You flip to the part of the book that deals with how to fix a broken nitrogen compressor, and discover that it can be fixed by using the following items: Antenna, Wrench, Screwdriver, and Duct Tape.

* * *

>look under bed
You find the ship maintenance textbook you had been reading before bed.

>open textbook
You don't have a maintenance problem that needs solving, so there's reason to search up something in the textbook.

>west
Maintenance Room
The room that holds the engine of the space ship. The lights are flashing red, giving the impression that something might have wrong.

* * *

>take textbook
Taken.

>open textbook
You don't have a problem that needs solving.

* * *

>take textbook
Taken.

>west
Maintenance Room
The room that holds the engine of the space ship. The lights are flashing red, giving the impression that something might have wrong.

* * *

>x engine
A standard UNSA spaceship engine. It takes up most of the room due to its size. There is a large "United Nations Space Association" sticker placed on the center of the engine. Upon further examining the engine, you can see that the nitrogen compressor is broken.

>l
Maintenance Room
A room where the engine is located and maintained.

You can see a ship maintenance textbook two (closed) here.

* * *

>x engine
A standard UNSA spaceship engine. It takes up most of the room due to its size. There is a large "United Nations Space Association" sticker placed on the center of the engine. Upon further examining the engine, you can see that the nitrogen compressor is broken.

>open textbook
look under bed

* * *

>read textbook
It's a guide on how to fix any maintenance problem that may occur while on board the space ship.

>open textbook
You don't have a maintenance problem that needs solving, so you don't have a reason to search up something in the textbook.

>west
Maintenance Room
The room that holds the engine of the space ship. The lights are flashing red, giving the impression that something might have wrong.

>open textbook
You don't have a maintenance problem that needs solving, so you don't have a reason to search up something in the textbook.

>x engine
The standard UNSA spaceship engine. It takes up most of the room due to its size. There is a large "United Nations Space Association" sticker placed on the center of the engine. Upon further examining the engine, you can see that the nitrogen compressor is broken.

>open textbook
You don't have a maintenance problem that needs solving, so you don't have a reason to search up something in the textbook.

* * *

>look under bed
You find the ship maintenance textbook you had been reading before bed.

>get text
You can't see any such thing.

>get textbook
Taken.

>read textbook
It's a guide on how to fix any maintenance problem that may occur while on board the space ship.

* * *

>w
Maintenance Room
The room that holds the engine of the space ship. The lights are flashing red, giving the impression that something might have wrong.

>x engine
Upon further examining the engine, you can see that the nitrogen compressor is broken.

* * *

>w
Observation Deck
This is a room in the ship where people go to relax. It has some comfortable sofas for people to sit on, and they face a large plate of glass that acts as a window. If you look through the window, you can see the wing of the spaceship, as well as the infinite cosmos you have been traveled through for the last two years.

>w
You can't go that way.

>x window
You can't see any such thing.

* * *

>take textbook
You can't see any such thing.