The ringing of your alarm clock wakes you up. You get out of bed to find that none of your fellow crew members are in the crew's quarters. They probably just went to breakfast. You had hoped for a cushy engineering job on Earth, but the UNSA had other plans for your career. It's been two years since you were assigned to this ship, and your team hasn't been able to find any sign of alien life in the cosmos. As you are changing from your pajamas into your uniform, you hear a loud voice booming from the intercom.

Houston, We Have a Problem
An Interactive Fiction by Leo Kodish
Release 1 / Serial number 140219 / Inform 7 build 6G60 (I6/v6.32 lib 6/12N) SD

Crew's Quarters
This is the room you have shared with your fellow astronauts for the last two years. The room is large enough to fit the twenty or so bunks needed to accomodate all of the astronauts on the ship. You don't have a bedside desk or anything like that, so you've had to keep your reading material under your bed. The engine room is to your west.

>x textbook
You can't see any such thing.

>under bed
That's not a verb I recognise.

>look under bed
You find the ship maintenance textbook you had been reading before bed.

>x textbook
It's a guide on how to fix any maintenance problem that may occur while on the space ship.

* * *

>x bunk
Your bed

* * *

>look under bed
You find the ship maintenance textbook you had been reading before bed.

>look under bunk
You find nothing of interest.

>look under ed
You can't see any such thing.

>look under bed
You find nothing of interest.

* * *

>look under bunk
You find the ship maintenance textbook you had been reading before bed.

>look under bunk
The textbook was all you kept down here. There's nothing else.

>look under bunk
You find nothing of interest.

* * *

>look under bunk
You find the ship maintenance textbook you had been reading before bed.

>look
Crew's Quarters
This is the room you have shared with your fellow astronauts for the last two years. The room is large enough to fit the twenty or so bunks needed to accomodate all of the astronauts on the ship. You don't have a bedside desk or anything like that, so you've had to keep your engineering textbook under your bed.

You can see a ship maintenance textbook here.

* * *

>look under bed
You find the ship maintenance textbook you had been reading before bed.

* * *

>take textbook
Taken.

>inv
You are carrying:
  a ship maintenance textbook

>x textbook
You see nothing special about the ship maintenance textbook.

>read textbook
You see nothing special about the ship maintenance textbook.

* * *

>look under bed
You find the ship maintenance textbook you had been reading before bed.

>look under bed
The textbook was all you kept down here. There's nothing else.

* * *

>west
Maintenance Room
A room where the engine is located and maintained.

>x engine
You see nothing special about the Engine.

* * *

>west
Maintenance Room
A room where the engine is located and maintained.

>l
Maintenance Room
A room where the engine is located and maintained.

* * *

>west
Maintenance Room
A room where the engine is located and maintained.

I beg your pardon?

* * *

>look under bved
You can't see any such thing.

>look under bed
You find the ship maintenance textbook you had been reading before bed.

>look under bed
You find nothing of interest.

>look under bed
The textbook was all you kept down here. There's nothing else.