The ringing of your alarm clock wakes you up. You get out of bed to find that none of your fellow crew members are in the crew's quarters. They probably just went to breakfast. You had hoped for a cushy engineering job on Earth, but the UNSA had other plans for your career. It's been two years since you were assigned to this ship, and your team hasn't been able to find any sign of alien life in the cosmos. As you change from your pajamas into your uniform, you hear a loud voice booming from the intercom.

Houston, We Have a Problem
An Interactive Fiction by Leo Kodish
Release 1 / Serial number 140307 / Inform 7 build 6G60 (I6/v6.32 lib 6/12N) SD

Crew's Quarters
This is the room you have shared with your fellow astronauts for the last two years. The room is large enough to fit the twenty or so beds needed to accomodate all of the astronauts on the ship. You don't have a bedside desk or anything like that, so you've had to keep your reading material under your bed. 
The Maintenance Room is to your west.

>take metal bars
You don't see any way you could possibly remove those.

* * *

>look under bde
You can't see any such thing.

>l under bed
You find the ship maintenance textbook you had been reading before bed.

>take bok
You can't see any such thing.

>take book
Taken.

>open book
You don't have a maintenance problem that needs solving, so there's no reason to look up anything in the textbook.

>w
Maintenance Room
The room that holds the engine of the space ship. The lights are flashing red, giving the impression that something might have gone wrong.

ATTENTION! This is a emergency UNSA brodcast. Most of your crewmates have safely evacuated the ship on escape pods, but if anyone is still aboard this ship, your engine has malfunctioned, and will explode unless it is fixed. We have sent a rescue team to save any crew members who may still be aboard the ship, but we predict the engine to explode before we can reach you, so you must fix the engine in order to give us enough time to save you.

>x engine
A standard UNSA spaceship engine. It takes up most of the room due to its size. There is a large "United Nations Space Association" sticker placed in the middle of the engine. Upon further examining the engine, you can see that the nitrogen compressor is broken.

A standard UNSA spaceship engine. It takes up most of the room due to its size. There is a large "United Nations Space Association" sticker placed in the middle of the engine. Upon further examining the engine, you can see that the nitrogen compressor is broken.

* * *

>x beds
You can't see any such thing.

>x bed
A folding bed with an old mattress on it. It's similar to a standard military bed, with a metal headboard and bed frame.

>look under mattress
You can't see any such thing.

>x headboard
You can't see any such thing.

>x bed frame
I only understood you as far as wanting to examine the bed.

>look under bed
You find the ship maintenance textbook you had been reading before bed.

>take bok
You can't see any such thing.

* * *

>take book
Taken.

>read book
It's a guide on how to fix any maintenance problem that may occur while on board the space ship.

>l
Crew's Quarters
This is the room you have shared with your fellow astronauts for the last two years. The room is large enough to fit the twenty or so beds needed to accomodate all of the astronauts on the ship. You don't have a bedside desk or anything like that, so you've had to keep your reading material under your bed. 
The Maintenance Room is to your west.

>west
Maintenance Room
The room that holds the engine of the space ship. The lights are flashing red, giving the impression that something might have gone wrong with the engine. 
The Crew's Quarters are to the East. The Mess Hall is to the North, and the Observation Deck is to the West.

ATTENTION! This is a emergency UNSA brodcast. Most of your crewmates have safely evacuated the ship on escape pods, but if anyone is still aboard this ship, your engine has malfunctioned, and will explode unless it is fixed. We have sent a rescue team to save any crew members who may still be aboard the ship, but we predict the engine to explode before we can reach you, so you must fix the engine in order to give us enough time to save you.

>fix engine
That's not a verb I recognise.

>west
Observation Deck
This is a room in the ship where people go to relax. It has some comfortable sofas for people to sit on, and they face a large plate of glass that acts as a window. If you look through the window, you can see the wing of the spaceship, as well as the infinite cosmos you have been traveled through for the last two years. 
The Medical Bay is to the West. The Airlock is to the North. The Command Room is to the South, and the Maintenance Room is to the East.

>look throgh window
You can't see any such thing.

>x windiw
You can't see any such thing.

>x window
You look through the window, staring out at the thousands of stars your ship passes by. You can see the wing of the spaceship, and you see an antenna planted on the wing.

>l
Observation Deck
This is a room in the ship where people go to relax. It has some comfortable sofas for people to sit on, and they face a large plate of glass that acts as a window. If you look through the window, you can see the wing of the spaceship, as well as the infinite cosmos you have been traveled through for the last two years. 
The Medical Bay is to the West. The Airlock is to the North. The Command Room is to the South, and the Maintenance Room is to the East.

>north
Airlock
This is the Airlock. The room where the astronauts on the ship must go through in order to enter space. The airlock door to the North leads to the wing of the spaceship.

You can see a large oxygen tank that you can hook up to your spacesuit using a tube to transfer air into your suit while out in space.

>take tank
Taken.

>x tank
You see nothing special about the oxygen tank.

>l
Airlock
This is the Airlock. The room where the astronauts on the ship must go through in order to enter space. The airlock door to the North leads to the wing of the spaceship.

>s
Observation Deck
This is a room in the ship where people go to relax. It has some comfortable sofas for people to sit on, and they face a large plate of glass that acts as a window. If you look through the window, you can see the wing of the spaceship, as well as the infinite cosmos you have been traveled through for the last two years. 
The Medical Bay is to the West. The Airlock is to the North. The Command Room is to the South, and the Maintenance Room is to the East.

>s
Command Room
It is a room that was used by the main security officer to watch over the ship. They are television moniters on the walls that he used to observe the rooms on the ship You can also see the desk the officer would sit in to observe the moniters. 
The Observation Deck is to the North.

>x desk
a desk that the security officer would sit in while he observed the moniters. It has a drawer that the officer could put things in.

>open drawer
It doesn't look like the security officer kept much in here, but you do see a roll of duct tape in the drawer.

>take duct tape
Taken.

>l
Command Room
It is a room that was used by the main security officer to watch over the ship. They are television moniters on the walls that he used to observe the rooms on the ship You can also see the desk the officer would sit in to observe the moniters. 
The Observation Deck is to the North.

>x monitors
You can't see any such thing.

>x moniters
The moniters are showing the command room. You can see yourself as you stare at the moniters, you also notice a book you didn't notice before behind the security officer's desk.

The moniters are showing the command room. You can see yourself as you stare at the moniters, you also notice a book you didn't notice before behind the security officer's desk.

>take book
(the Security Handbook)
Taken.

>read book
Which do you mean, the Security Handbook or the ship maintenance textbook?

>security
A textbook on basic security. The security officer must read this in his spare time.

>l
Command Room
It is a room that was used by the main security officer to watch over the ship. They are television moniters on the walls that he used to observe the rooms on the ship You can also see the desk the officer would sit in to observe the moniters. 
The Observation Deck is to the North.

>n
Observation Deck
This is a room in the ship where people go to relax. It has some comfortable sofas for people to sit on, and they face a large plate of glass that acts as a window. If you look through the window, you can see the wing of the spaceship, as well as the infinite cosmos you have been traveled through for the last two years. 
The Medical Bay is to the West. The Airlock is to the North. The Command Room is to the South, and the Maintenance Room is to the East.

>w
Medical Bay
A room that is used to treat any injuries that the astronauts may have on the ship. You see a storage locker used to hold chemicals and medical equipment. Most of the equipment in the room appears to have been taken by the evacuated crew members, but there still might be something in the storage locker. 
The Observation Deck is ot the East.

>open locker
It appears that the most of the medicine and equipment has been taken, but you can see a scalpel and medical tubing that have been left behind.

>take all
scalpel: Taken.
medical tubing: Taken.

>x scalpel
A sharp knife that is normally used for medical procedures, but it could have other uses as well.

>x tubing
a thin and very long clear tube that is usually used in catheters, but hopefully you won't have to use it for anything like that.

>l
Medical Bay
A room that is used to treat any injuries that the astronauts may have on the ship. You see a storage locker used to hold chemicals and medical equipment. Most of the equipment in the room appears to have been taken by the evacuated crew members, but there still might be something in the storage locker. 
The Observation Deck is ot the East.

>east
Observation Deck
This is a room in the ship where people go to relax. It has some comfortable sofas for people to sit on, and they face a large plate of glass that acts as a window. If you look through the window, you can see the wing of the spaceship, as well as the infinite cosmos you have been traveled through for the last two years. 
The Medical Bay is to the West. The Airlock is to the North. The Command Room is to the South, and the Maintenance Room is to the East.

>n
Airlock
This is the Airlock. The room where the astronauts on the ship must go through in order to enter space. The airlock door to the North leads to the wing of the spaceship.

>open airlock
You can't see any such thing.

>open door
You can't see any such thing.

>n
You open the airlock door and step out into space, but you suffocate without any oxygen to breath.

    *** You have died ***

Would you like to RESTART, RESTORE a saved game, QUIT or UNDO the last command?

>undo
Airlock
[Previous turn undone.]

>l
Airlock
This is the Airlock. The room where the astronauts on the ship must go through in order to enter space. The airlock door to the North leads to the wing of the spaceship.

>south
Observation Deck
This is a room in the ship where people go to relax. It has some comfortable sofas for people to sit on, and they face a large plate of glass that acts as a window. If you look through the window, you can see the wing of the spaceship, as well as the infinite cosmos you have been traveled through for the last two years. 
The Medical Bay is to the West. The Airlock is to the North. The Command Room is to the South, and the Maintenance Room is to the East.

>south
Command Room
It is a room that was used by the main security officer to watch over the ship. They are television moniters on the walls that he used to observe the rooms on the ship You can also see the desk the officer would sit in to observe the moniters. 
The Observation Deck is to the North.

>e
You can't go that way.

* * *

>e
Maintenance Room
The room that holds the engine of the space ship. The lights are flashing red, giving the impression that something might have gone wrong with the engine. 
The Crew's Quarters are to the East. The Mess Hall is to the North, and the Observation Deck is to the West.

>e
Crew's Quarters
This is the room you have shared with your fellow astronauts for the last two years. The room is large enough to fit the twenty or so beds needed to accomodate all of the astronauts on the ship. You don't have a bedside desk or anything like that, so you've had to keep your reading material under your bed. 
The Maintenance Room is to your west.

>e
You can't go that way.

>w
Maintenance Room
The room that holds the engine of the space ship. The lights are flashing red, giving the impression that something might have gone wrong with the engine. 
The Crew's Quarters are to the East. The Mess Hall is to the North, and the Observation Deck is to the West.

>w
Observation Deck
This is a room in the ship where people go to relax. It has some comfortable sofas for people to sit on, and they face a large plate of glass that acts as a window. If you look through the window, you can see the wing of the spaceship, as well as the infinite cosmos you have been traveled through for the last two years. 
The Medical Bay is to the West. The Airlock is to the North. The Command Room is to the South, and the Maintenance Room is to the East.

>n
Airlock
This is the Airlock. The room where the astronauts on the ship must go through in order to enter space. The airlock door to the North leads to the wing of the spaceship.

>n
You open the airlock door and step out into space, but you suffocate without any oxygen to breath.

    *** You have died ***

Would you like to RESTART, RESTORE a saved game, QUIT or UNDO the last command?

* * *

>s
Observation Deck
This is a room in the ship where people go to relax. It has some comfortable sofas for people to sit on, and they face a large plate of glass that acts as a window. If you look through the window, you can see the wing of the spaceship, as well as the infinite cosmos you have been traveled through for the last two years. 
The Medical Bay is to the West. The Airlock is to the North. The Command Room is to the South, and the Maintenance Room is to the East.

>i
You are carrying:
  a medical tubing
  a scalpel
  a Security Handbook
  a duct tape
  an oxygen tank
  a ship maintenance textbook (closed)

>combine tubing with tank
You can't combine the medical tubing and the oxygen tank into anything useful.

>combine duct tape with tubing
You can't combine the duct tape and the medical tubing into anything useful.

>combine duct tape with tank
You can't combine the duct tape and the oxygen tank into anything useful.

>read book
Which do you mean, the Security Handbook or the ship maintenance textbook?

* * *

>security
A textbook on basic security. The security officer must read this in his spare time.

>open book
Which do you mean, the Security Handbook or the ship maintenance textbook?

>security
You flip to a page about lockpicking, and see that a scalpel can be used to unlock a locked door if you aren't in possesion of a lockpick.

>open book
Which do you mean, the Security Handbook or the ship maintenance textbook?

>ship mainenance
I only understood you as far as wanting to open the ship maintenance textbook.

>ship maintenance
That's not a verb I recognise.

>open ship maintenance
You don't have a maintenance problem that needs solving, so there's no reason to look up anything in the textbook.

>l
Observation Deck
This is a room in the ship where people go to relax. It has some comfortable sofas for people to sit on, and they face a large plate of glass that acts as a window. If you look through the window, you can see the wing of the spaceship, as well as the infinite cosmos you have been traveled through for the last two years. 
The Medical Bay is to the West. The Airlock is to the North. The Command Room is to the South, and the Maintenance Room is to the East.

>n
Airlock
This is the Airlock. The room where the astronauts on the ship must go through in order to enter space. The airlock door to the North leads to the wing of the spaceship.

>s
Observation Deck
This is a room in the ship where people go to relax. It has some comfortable sofas for people to sit on, and they face a large plate of glass that acts as a window. If you look through the window, you can see the wing of the spaceship, as well as the infinite cosmos you have been traveled through for the last two years. 
The Medical Bay is to the West. The Airlock is to the North. The Command Room is to the South, and the Maintenance Room is to the East.

* * *

>s
Command Room
It is a room that was used by the main security officer to watch over the ship. They are television moniters on the walls that he used to observe the rooms on the ship You can also see the desk the officer would sit in to observe the moniters. 
The Observation Deck is to the North.

I beg your pardon?

>x moniters
The moniters are showing the command room. You can see yourself as you stare at the moniters, you also notice a book you didn't notice before behind the security officer's desk.

The moniters are showing the command room. You can see yourself as you stare at the moniters, you also notice a book you didn't notice before behind the security officer's desk.

I beg your pardon?

>l
Command Room
It is a room that was used by the main security officer to watch over the ship. They are television moniters on the walls that he used to observe the rooms on the ship You can also see the desk the officer would sit in to observe the moniters. 
The Observation Deck is to the North.

You can see a Security Handbook here.

>e
You can't go that way.

* * *

>n
Observation Deck
This is a room in the ship where people go to relax. It has some comfortable sofas for people to sit on, and they face a large plate of glass that acts as a window. If you look through the window, you can see the wing of the spaceship, as well as the infinite cosmos you have been traveled through for the last two years. 
The Medical Bay is to the West. The Airlock is to the North. The Command Room is to the South, and the Maintenance Room is to the East.

>n
Airlock
This is the Airlock. The room where the astronauts on the ship must go through in order to enter space. The airlock door to the North leads to the wing of the spaceship.

* * *

>s
Observation Deck
This is a room in the ship where people go to relax. It has some comfortable sofas for people to sit on, and they face a large plate of glass that acts as a window. If you look through the window, you can see the wing of the spaceship, as well as the infinite cosmos you have been traveled through for the last two years. 
The Medical Bay is to the West. The Airlock is to the North. The Command Room is to the South, and the Maintenance Room is to the East.

>w
Medical Bay
A room that is used to treat any injuries that the astronauts may have on the ship. You see a storage locker used to hold chemicals and medical equipment. Most of the equipment in the room appears to have been taken by the evacuated crew members, but there still might be something in the storage locker. 
The Observation Deck is ot the East.

>cut tubing with scalpel
I only understood you as far as wanting to cut the medical tubing.

>cut tubing
Cutting that up would achieve little.

>cut tape
Cutting that up would achieve little.

>l
Medical Bay
A room that is used to treat any injuries that the astronauts may have on the ship. You see a storage locker used to hold chemicals and medical equipment. Most of the equipment in the room appears to have been taken by the evacuated crew members, but there still might be something in the storage locker. 
The Observation Deck is ot the East.

>e
Observation Deck
This is a room in the ship where people go to relax. It has some comfortable sofas for people to sit on, and they face a large plate of glass that acts as a window. If you look through the window, you can see the wing of the spaceship, as well as the infinite cosmos you have been traveled through for the last two years. 
The Medical Bay is to the West. The Airlock is to the North. The Command Room is to the South, and the Maintenance Room is to the East.

>s
Command Room
It is a room that was used by the main security officer to watch over the ship. They are television moniters on the walls that he used to observe the rooms on the ship You can also see the desk the officer would sit in to observe the moniters. 
The Observation Deck is to the North.

You can see a Security Handbook here.

>i
You are carrying:
  a medical tubing
  a scalpel
  a duct tape
  an oxygen tank
  a ship maintenance textbook (closed)

>take security handbook
Taken.

>open securirty handbook
You can't see any such thing.

>open security handbook
You flip to a page about lockpicking, and see that a scalpel can be used to unlock a locked door if you aren't in possesion of a lockpick.

I beg your pardon?

>i
You are carrying:
  a Security Handbook
  a medical tubing
  a scalpel
  a duct tape
  an oxygen tank
  a ship maintenance textbook (closed)

>e
You can't go that way.

* * *

>e
Maintenance Room
The room that holds the engine of the space ship. The lights are flashing red, giving the impression that something might have gone wrong with the engine. 
The Crew's Quarters are to the East. The Mess Hall is to the North, and the Observation Deck is to the West.

>n
Mess Hall
This is the room where the astronauts eat their meals. There are long table for eating, similar to what you would see in a school cafeteria. It's around breakfast time, so this room should be bustling with hungry crew members, but they've all left the ship. You thought you were the only person left on the ship, but you see a very hungry looking astronaut sitting down at one of the tables. 
The Kitchen is to the North

The astronaut is clutching his stomach. You can here it growling all the way from where you're standing. He's wearing a spacesuit, which would allow him to go outside of the ship if he wanted to.

You can also see a kitchen door here.

>open door
It seems to be locked.

* * *

>scalpel
You unlock the kitchen door.

>open door
You open the kitchen door.

>l
Mess Hall
This is the room where the astronauts eat their meals. There are long table for eating, similar to what you would see in a school cafeteria. It's around breakfast time, so this room should be bustling with hungry crew members, but they've all left the ship. You thought you were the only person left on the ship, but you see a very hungry looking astronaut sitting down at one of the tables. 
The Kitchen is to the North

The astronaut is clutching his stomach. You can here it growling all the way from where you're standing. He's wearing a spacesuit, which would allow him to go outside of the ship if he wanted to.

You can also see a kitchen door here.

>n
Kitchen
The room where the head chef aboard the ship would prepare all of the meals for the crew members. It appears that most of the food and supplies have been taken by the crew members who left on the escape pods. You can see the refrigerator where the chef would keep all of his ingredients. 
The Mess Hall is to the South.

You can see a kitchen door here.

>open refigerator
You can't see any such thing.

>open refrigerator
You open the refrigerator, revealing a sandwich.

>take sandwich
Taken.

>l
Kitchen
The room where the head chef aboard the ship would prepare all of the meals for the crew members. It appears that most of the food and supplies have been taken by the crew members who left on the escape pods. You can see the refrigerator where the chef would keep all of his ingredients. 
The Mess Hall is to the South.

You can see a kitchen door here.

>s
Mess Hall
This is the room where the astronauts eat their meals. There are long table for eating, similar to what you would see in a school cafeteria. It's around breakfast time, so this room should be bustling with hungry crew members, but they've all left the ship. You thought you were the only person left on the ship, but you see a very hungry looking astronaut sitting down at one of the tables. 
The Kitchen is to the North

The astronaut is clutching his stomach. You can here it growling all the way from where you're standing. He's wearing a spacesuit, which would allow him to go outside of the ship if he wanted to.

You can also see a kitchen door here.

>give sandwich to astronaut
The astronaut gratefully accepts the sandwich, and begins eating. He finishes the sandwich in just a few seconds.

>ask astronaut about spacesuit
There is no reply.

>talk to astronaut
Thank you so much. I thought I was going to starve for a second. I guess I owe you a spacesuit. Here you go: 

He offers you his space suit.

* * *

>take suit
Taken.

>wear suit
You put on the space suit.

>l
Mess Hall
This is the room where the astronauts eat their meals. There are long table for eating, similar to what you would see in a school cafeteria. It's around breakfast time, so this room should be bustling with hungry crew members, but they've all left the ship. You thought you were the only person left on the ship, but you see a very hungry looking astronaut sitting down at one of the tables. 
The Kitchen is to the North

The astronaut is clutching his stomach. You can here it growling all the way from where you're standing. He's wearing a spacesuit, which would allow him to go outside of the ship if he wanted to.

You can also see a kitchen door here.

>s
Maintenance Room
The room that holds the engine of the space ship. The lights are flashing red, giving the impression that something might have gone wrong with the engine. 
The Crew's Quarters are to the East. The Mess Hall is to the North, and the Observation Deck is to the West.

* * *

>l
Airlock
This is the Airlock. The room where the astronauts on the ship must go through in order to enter space. The airlock door to the North leads to the wing of the spaceship.

>weat tank
That's not a verb I recognise.

>wear takn
You can't see any such thing.

>wear tank
You can't wear that!

>x tank
You see nothing special about the oxygen tank.

>attach tubing to tank
You can't combine the medical tubing and the oxygen tank into anything useful.

>x tubing
a thin and very long clear tube that is usually used in catheters, but hopefully you won't have to use it for anything like that.

>l
Airlock
This is the Airlock. The room where the astronauts on the ship must go through in order to enter space. The airlock door to the North leads to the wing of the spaceship.

>i
You are carrying:
  a space suit (being worn)
  a Security Handbook
  a medical tubing
  a scalpel
  a duct tape
  an oxygen tank
  a ship maintenance textbook (closed)

>combine tubing with duct tape
You can't combine the medical tubing and the duct tape into anything useful.

>l
Airlock
This is the Airlock. The room where the astronauts on the ship must go through in order to enter space. The airlock door to the North leads to the wing of the spaceship.

>x suit
You see nothing special about the space suit.

>attach suit to tank
You can't combine the space suit and the oxygen tank into anything useful.

>attach suit and tubing
You can't use multiple objects with that verb.

>attach suit to tubing
You now have a tubed space suit.

* * *

>x bed
A folding bed with an old mattress on it. It's similar to a standard military bed, with a metal headboard and bed frame.

>look under bed
You find the ship maintenance textbook you had been reading before bed.

>open book
You don't have a maintenance problem that needs solving, so there's no reason to look up anything in the textbook.

* * *

>look under bed
You find the Engine Debugger you had keep before bed.

>take debugger
Taken.

>x debugger
A device that when turned on, can be used to diagnose any problem that may occur with an type of engine, provided you are in the prescence of an engine to debug.

The Engine Debugger is currently switched off.

* * *

>w
Maintenance Room
The room that holds the engine of the space ship. The lights are flashing red, giving the impression that something might have gone wrong with the engine. 
The Crew's Quarters are to the East. The Mess Hall is to the North, and the Observation Deck is to the West.

ATTENTION! This is a emergency UNSA brodcast. Most of your crewmates have safely evacuated the ship on escape pods, but if anyone is still aboard this ship, your engine has malfunctioned, and will explode unless it is fixed. We have sent a rescue team to save any crew members who may still be aboard the ship, but we predict the engine to explode before we can reach you, so you must fix the engine in order to give us enough time to save you.

>turn engine debugger on
The engine debugger shows that there is engine is suffering from a broken nitrogen compressor. It says it can be fixed with a wrench,

* * *

>switch on debugger
The engine debugger shows that there is engine is suffering from a broken nitrogen compressor. It says it can be fixed with a wrench, and an antenna.

>turn on engine debugger
The engine debugger shows that there is engine is suffering from a broken nitrogen compressor. It says it can be fixed with a wrench, and an antenna.

* * *

>take debugger
Taken.

>turn debugger on
You switch the Engine Debugger on.

* * *

>look under bed
You find the Engine Debugger you had keep before bed.

>take book
Taken.

* * *

>open book
You don't have a maintenance problem that needs solving, so there's no reason to look up anything in the textbook.

>w
Maintenance Room
The room that holds the engine of the space ship. The lights are flashing red, giving the impression that something might have gone wrong. The Crew's Quarters are to the East. The Mess Hall is to the North, and the Observation Deck is to the West.

ATTENTION! This is a emergency UNSA brodcast. Most of your crewmates have safely evacuated the ship on escape pods, but if anyone is still aboard this ship, your engine has malfunctioned, and will explode unless it is fixed. We have sent a rescue team to save any crew members who may still be aboard the ship, but we predict the engine to explode before we can reach you, so you must fix the engine in order to give us enough time to save you.

>x engine
A standard UNSA spaceship engine. It takes up most of the room due to its size. There is a large "United Nations Space Association" sticker placed in the middle of the engine. Upon further examining the engine, you can see that the nitrogen compressor is broken.

A standard UNSA spaceship engine. It takes up most of the room due to its size. There is a large "United Nations Space Association" sticker placed in the middle of the engine. Upon further examining the engine, you can see that the nitrogen compressor is broken.

>open book
You flip to the part of the textbook dealing with how to fix a broken nitrogen compressor. You discover that it can be fixed by using the following items: Antenna, Wrench, Screwdriver, and Duct Tape.

* * *

>x engine
A standard UNSA spaceship engine. It takes up most of the room due to its size. There is a large "United Nations Space Association" sticker placed in the middle of the engine. Upon further examining the engine, you can see that the nitrogen compressor is broken.

A standard UNSA spaceship engine. It takes up most of the room due to its size. There is a large "United Nations Space Association" sticker placed in the middle of the engine. Upon further examining the engine, you can see that the nitrogen compressor is broken.

>x engine
A standard UNSA spaceship engine. It takes up most of the room due to its size. There is a large "United Nations Space Association" sticker placed in the middle of the engine. Upon further examining the engine, you can see that the nitrogen compressor is broken.

A standard UNSA spaceship engine. It takes up most of the room due to its size. There is a large "United Nations Space Association" sticker placed in the middle of the engine. Upon further examining the engine, you can see that the nitrogen compressor is broken.

* * *

>x book
It's a guide on how to fix any maintenance problem that may occur while on board the space ship.

>inv
You are carrying:
  a ship maintenance textbook (closed)

>open bok
You can't see any such thing.

* * *

>take book
Taken.

>w
Maintenance Room
The room that holds the engine of the space ship. The lights are flashing red, giving the impression that something might have gone wrong.

ATTENTION! This is a emergency UNSA brodcast. Most of your crewmates have safely evacuated the ship on escape pods, but if anyone is still aboard this ship, your engine has malfunctioned, and will explode unless it is fixed. We have sent a rescue team to save any crew members who may still be aboard the ship, but we predict the engine to explode before we can reach you, so you must fix the engine in order to give us enough time to save you.

>w
Observation Deck
This is a room in the ship where people go to relax. It has some comfortable sofas for people to sit on, and they face a large plate of glass that acts as a window. If you look through the window, you can see the wing of the spaceship, as well as the infinite cosmos you have been traveled through for the last two years.

>w
Medical Bay
A room that is used to treat any injuries that the astronauts may have on the ship. You see a storage locker used to hold chemicals and medical equipment. Most of the equipment in the room appears to have been taken by the evacuated crew members, but there still might be something in the storage locker.

>open locker
It appears that the most of the medicine and equipment has been taken, but you can see a scalpel and medical tubing that have been left behind.

>take medical ubing
I only understood you as far as wanting to take the medical tubing.

>take medical tubing
Taken.

>combine medical tubing with textbook
You now have an oxygen enhanced space suit.

>x space suit
You see nothing special about the oxygen enhanced space suit.

>x oxygen enhanced space suit
You see nothing special about the oxygen enhanced space suit.

* * *

>look under bd
You can't see any such thing.

>l under bed
You find the ship maintenance textbook you had been reading before bed.

>take book
Taken.

>inv
You are carrying:
  a ship maintenance textbook (closed)

>open book
You don't have a maintenance problem that needs solving, so there's no reason to look up anything in the textbook.

>inv
You are carrying:
  a ship maintenance textbook (closed)

>e
You can't go that way.

>look under bed
The textbook was all you kept down here. There's nothing else.

>look under bed
The textbook was all you kept down here. There's nothing else.

* * *

>x me
You are dressed in your UNSA engineers uniform. You have grown quite a long beard after being on this ship for two years without shaving.

* * *

>w
Maintenance Room
The room that holds the engine of the space ship. The lights are flashing red, giving the impression that something might have gone wrong with the engine. 
The Crew's Quarters are to the East. The Mess Hall is to the North, and the Observation Deck is to the West.

ATTENTION! This is a emergency UNSA brodcast. Most of your crewmates have safely evacuated the ship on escape pods, but if anyone is still aboard this ship, your engine has malfunctioned, and will explode unless it is fixed. We have sent a rescue team to save any crew members who may still be aboard the ship, but we predict the engine to explode before we can reach you, so you must fix the engine in order to give us enough time to save you.

>x engine
A standard UNSA spaceship engine. It takes up most of the room due to its size. There is a large "United Nations Space Association" sticker placed in the middle of the engine. Upon further examining the engine, you can see that the nitrogen compressor is broken.

>x spaceship engine
A standard UNSA spaceship engine. It takes up most of the room due to its size. There is a large "United Nations Space Association" sticker placed in the middle of the engine. Upon further examining the engine, you can see that the nitrogen compressor is broken.

>e
Crew's Quarters
This is the room you have shared with your fellow astronauts for the last two years. The room is large enough to fit the twenty or so beds needed to accomodate all of the astronauts on the ship. You don't have a bedside desk or anything like that, so you've had to keep your reading material under your bed. 
The Maintenance Room is to your west.

>look under bed
You find the Engine Debugger you had keep before bed.

* * *

>take debugger
Taken.

>x debugger
A device when turned on, can be used to diagnose any problem that may occur with an engine.

>turn debugger on
That's not something you can switch.