The ringing of your alarm clock wakes you up. You get out of bed to find that none of your fellow crew members are in the crew's quarters. They probably just went to breakfast. You had hoped for a cushy engineering job on Earth, but the UNSA had other plans for your career. It's been two years since you were assigned to this ship, and your team hasn't been able to find any sign of alien life in the cosmos. As you are changing from your pajamas into your uniform, you hear a loud voice booming from the intercom.

Houston, We Have a Problem
An Interactive Fiction by Leo Kodish
Release 1 / Serial number 140225 / Inform 7 build 6G60 (I6/v6.32 lib 6/12N) SD

Crew's Quarters
This is the room you have shared with your fellow astronauts for the last two years. The room is large enough to fit the twenty or so beds needed to accomodate all of the astronauts on the ship. You don't have a bedside desk or anything like that, so you've had to keep your reading material under your bed. The engine room is to your west.

>w
Maintenance Room
The room that holds the engine of the space ship. The lights are flashing red, giving the impression that something might have wrong.

>x engine
A standard UNSA spaceship engine. It takes up most of the room due to its size. There is a large "United Nations Space Association" sticker placed on the center of the engine. Upon further examining the engine, you can see that the nitrogen compressor is broken.

* * *

>w
Maintenance Room
The room that holds the engine of the space ship. The lights are flashing red, giving the impression that something might have wrong.

>w
Observation Deck
This is a room in the ship where people go to relax. It has some comfortable sofas for people to sit on, and they face a large plate of glass that acts as a window. If you look through the window, you can see the wing of the spaceship, as well as the infinite cosmos you have been traveled through for the last two years.

>w
Medical Bay
A room that is used to treat any injuries that the astronauts may have on the ship. You see a storage locker that is used to hold chemicals and medical equipment. Most of the equipment in the room appears to have been taken, but there still might be something in the storage locker.

>e
Observation Deck
This is a room in the ship where people go to relax. It has some comfortable sofas for people to sit on, and they face a large plate of glass that acts as a window. If you look through the window, you can see the wing of the spaceship, as well as the infinite cosmos you have been traveled through for the last two years.

>s
Command Room
It is a room that was used by the main security officer to watch over the ship. They are television moniters on the walls that he used to observe the rooms on the ship.

>x television moniters
The moniters are showing the command room. You can see yourself as you stare at the moniters, you also notice a book you didn't notice before behind the security officer's desk.

>take book
You can't see any such thing.

>x desk
a desk that the security officer would sit in while he observed the moniters. It has a drawer that the officer could put things in.

>open desk
It doesn't look like the security officer kept much in here, but you see a roll of duct tape in the drawer.

>open drawer
You can't see any such thing.

* * *

>s
Command Room
It is a room that was used by the main security officer to watch over the ship. They are television moniters on the walls that he used to observe the rooms on the ship.

>open drawer
It doesn't look like the security officer kept much in here, but you see a roll of duct tape in the drawer.

>take tape
Taken.

>inv
You are carrying:
  a duct tape

* * *

>w
Medical Bay
A room that is used to treat any injuries that the astronauts may have on the ship. You see a storage locker that is used to hold chemicals and medical equipment. Most of the equipment in the room appears to have been taken, but there still might be something in the storage locker.

>open locker
It appears that the most of the medicine and equipment has been taken, but you can see a scalpel and medical tubing that have been left behind.

* * *

>w
Medical Bay
A room that is used to treat any injuries that the astronauts may have on the ship. You see a storage locker that is used to hold chemicals and medical equipment. Most of the equipment in the room appears to have been taken, but there still might be something in the storage locker.

>open storage locker
It appears that the most of the medicine and equipment has been taken, but you can see a scalpel and medical tubing that have been left behind.

>take scalpel and medical tubing
scalpel: Taken.
medical tubing: Taken.

>inv
You are carrying:
  a medical tubing
  a scalpel

>x scalpel
A sharp knife that is normally used for medical procedures, but it could have other uses as well.

>x medical tubing
a thin and very long clear tube that is usually used in catheters, but hopefully you won't have to use it for anything like that.

* * *

>w
Observation Deck
This is a room in the ship where people go to relax. It has some comfortable sofas for people to sit on, and they face a large plate of glass that acts as a window. If you look through the window, you can see the wing of the spaceship, as well as the infinite cosmos you have been traveled through for the last two years.

>n
You can't go that way.

>e
Maintenance Room
The room that holds the engine of the space ship. The lights are flashing red, giving the impression that something might have wrong.

>w
Observation Deck
This is a room in the ship where people go to relax. It has some comfortable sofas for people to sit on, and they face a large plate of glass that acts as a window. If you look through the window, you can see the wing of the spaceship, as well as the infinite cosmos you have been traveled through for the last two years.

* * *

>n
You can't go that way.

>w
Medical Bay
A room that is used to treat any injuries that the astronauts may have on the ship. You see a storage locker that is used to hold chemicals and medical equipment. Most of the equipment in the room appears to have been taken, but there still might be something in the storage locker.

* * *

>open storage locker
It appears that the most of the medicine and equipment has been taken, but you can see a scalpel and medical tubing that have been left behind.

>take scalpel
Taken.

>take medical tubing
Taken.

>l
Medical Bay
A room that is used to treat any injuries that the astronauts may have on the ship. You see a storage locker that is used to hold chemicals and medical equipment. Most of the equipment in the room appears to have been taken, but there still might be something in the storage locker.

>inv
You are carrying:
  a medical tubing
  a scalpel

>e
Observation Deck
This is a room in the ship where people go to relax. It has some comfortable sofas for people to sit on, and they face a large plate of glass that acts as a window. If you look through the window, you can see the wing of the spaceship, as well as the infinite cosmos you have been traveled through for the last two years.

>e
Maintenance Room
The room that holds the engine of the space ship. The lights are flashing red, giving the impression that something might have wrong.

>e
Crew's Quarters
This is the room you have shared with your fellow astronauts for the last two years. The room is large enough to fit the twenty or so beds needed to accomodate all of the astronauts on the ship. You don't have a bedside desk or anything like that, so you've had to keep your reading material under your bed. The engine room is to your west.

>look under bed
You find the ship maintenance textbook you had been reading before bed.

* * *

>take book
You can't see any such thing.

>take textbook
Taken.

>w
Maintenance Room
The room that holds the engine of the space ship. The lights are flashing red, giving the impression that something might have wrong.

>n
Mess Hall
This is the room where the astronauts eat their meals. There are long table for eating, similar to what you would see in a school cafeteria. It's around breakfast time, so this room should be bustling with hungry crew members, but they've all left the ship. You thought you were the only person left on the ship, but you see a very hungry looking astronaut sitting down at one of the tables.

An astronaut who is clutching his stomach. You can here it growling all the way from where you're standing. He's wearing a spacesuit, which would allow him to go outside of the ship if he needed to.

>talk to astronaut
That's not a verb I recognise.

>x astronaut
You see nothing special about the astronaut.

>open textboojk
You can't see any such thing.

>open textbook
You don't have a maintenance problem that needs solving, so there's reason to search up something in the textbook.

>s
Maintenance Room
The room that holds the engine of the space ship. The lights are flashing red, giving the impression that something might have wrong.

>e
Crew's Quarters
This is the room you have shared with your fellow astronauts for the last two years. The room is large enough to fit the twenty or so beds needed to accomodate all of the astronauts on the ship. You don't have a bedside desk or anything like that, so you've had to keep your reading material under your bed. The engine room is to your west.

>w
Maintenance Room
The room that holds the engine of the space ship. The lights are flashing red, giving the impression that something might have wrong.

* * *

>x engine
A standard UNSA spaceship engine. It takes up most of the room due to its size. There is a large "United Nations Space Association" sticker placed on the center of the engine. Upon further examining the engine, you can see that the nitrogen compressor is broken.

>open textbook
You don't have a maintenance problem that needs solving, so there's reason to search up something in the textbook.

* * *

>w
Maintenance Room
The room that holds the engine of the space ship. The lights are flashing red, giving the impression that something might have wrong.

>e
Crew's Quarters
This is the room you have shared with your fellow astronauts for the last two years. The room is large enough to fit the twenty or so beds needed to accomodate all of the astronauts on the ship. You don't have a bedside desk or anything like that, so you've had to keep your reading material under your bed. The engine room is to your west.

* * *

>w
Observation Deck
This is a room in the ship where people go to relax. It has some comfortable sofas for people to sit on, and they face a large plate of glass that acts as a window. If you look through the window, you can see the wing of the spaceship, as well as the infinite cosmos you have been traveled through for the last two years.

>e
Maintenance Room
The room that holds the engine of the space ship. The lights are flashing red, giving the impression that something might have wrong.

>n
Mess Hall
This is the room where the astronauts eat their meals. There are long table for eating, similar to what you would see in a school cafeteria. It's around breakfast time, so this room should be bustling with hungry crew members, but they've all left the ship. You thought you were the only person left on the ship, but you see a very hungry looking astronaut sitting down at one of the tables.

The astronaut is clutching his stomach. You can here it growling all the way from where you're standing. He's wearing a spacesuit, which would allow him to go outside of the ship if he wanted to.

>talk to astronaut
That's not a verb I recognise.

>ask astronaut
(for the Astronaut)
(The Astronaut first taking the Astronaut)
The Astronaut has better things to do.

* * *

>w
Maintenance Room
The room that holds the engine of the space ship. The lights are flashing red, giving the impression that something might have wrong.

>n
Mess Hall
This is the room where the astronauts eat their meals. There are long table for eating, similar to what you would see in a school cafeteria. It's around breakfast time, so this room should be bustling with hungry crew members, but they've all left the ship. You thought you were the only person left on the ship, but you see a very hungry looking astronaut sitting down at one of the tables.

The astronaut is clutching his stomach. You can here it growling all the way from where you're standing. He's wearing a spacesuit, which would allow him to go outside of the ship if he wanted to.

>talk to astronaut
a

* * *

>talk to astronua
You can't see any such thing.

>talk to astronaut
I'm so hungry! Please, just give me some food. I would do anything. I would even give you my space suitif you just brought me some food.

>n
Kitchen
The room where the head chef aboard the ship would prepare all of the meals for the crew members. It appears that most of the food and supplies have been taken by the crew members who left on the escape pods. You can see the refrigerator where the chef would keep all of his ingredients.

* * *

>give sandwich to astronaut
The Astronaut doesn't seem interested.

* * *

>n
Kitchen
The room where the head chef aboard the ship would prepare all of the meals for the crew members. It appears that most of the food and supplies have been taken by the crew members who left on the escape pods. You can see the refrigerator where the chef would keep all of his ingredients.

>open kitchen
You can't see any such thing.

>open fridge
You open the refrigerator, revealing a sandwich.

* * *

>give sandwich to astronaut
The astronaut gratefully accepts the sandwich, and begins eating. He finishes the sandwich in just a few seconds.

>talk to astronaut
Thank you so much. I thought I was going to starve for a second. I guess I owe you a spacesuit. Here you go. 
 He gives you his space suit.

* * *

>give sandwich to astronaut
The astronaut gratefully accepts the sandwich, and begins eating. He finishes the sandwich in just a few seconds.

>talk to astronaut
Thank you so much. I thought I was going to starve for a second. I guess I owe you a spacesuit. Here you go. 

He gives you his space suit.

>inv
You are carrying:
  a space suit

>w
You can't go that way.

>n
Kitchen
The room where the head chef aboard the ship would prepare all of the meals for the crew members. It appears that most of the food and supplies have been taken by the crew members who left on the escape pods. You can see the refrigerator where the chef would keep all of his ingredients.

>s
Mess Hall
This is the room where the astronauts eat their meals. There are long table for eating, similar to what you would see in a school cafeteria. It's around breakfast time, so this room should be bustling with hungry crew members, but they've all left the ship. You thought you were the only person left on the ship, but you see a very hungry looking astronaut sitting down at one of the tables.

The astronaut is clutching his stomach. You can here it growling all the way from where you're standing. He's wearing a spacesuit, which would allow him to go outside of the ship if he wanted to.

>s
Maintenance Room
The room that holds the engine of the space ship. The lights are flashing red, giving the impression that something might have wrong.

>w
Observation Deck
This is a room in the ship where people go to relax. It has some comfortable sofas for people to sit on, and they face a large plate of glass that acts as a window. If you look through the window, you can see the wing of the spaceship, as well as the infinite cosmos you have been traveled through for the last two years.

>x window
You look through the window, staring out at the thousands of stars your ship passes by. You can see the wing of the spaceship, and you see an antenna planted on the wing.

>x antenna
You can't see any such thing.

>w
Medical Bay
A room that is used to treat any injuries that the astronauts may have on the ship. You see a storage locker that is used to hold chemicals and medical equipment. Most of the equipment in the room appears to have been taken, but there still might be something in the storage locker.

>x storage locker
A locker that the ship's medic used to hold medical supplies.

>open storage locker
It appears that the most of the medicine and equipment has been taken, but you can see a scalpel and medical tubing that have been left behind.

* * *

>take scalpel
Taken.

>take tubing
Taken.

>inv
You are carrying:
  a medical tubing
  a scalpel
  a space suit

>e
Observation Deck
This is a room in the ship where people go to relax. It has some comfortable sofas for people to sit on, and they face a large plate of glass that acts as a window. If you look through the window, you can see the wing of the spaceship, as well as the infinite cosmos you have been traveled through for the last two years.

* * *

>s
Command Room
It is a room that was used by the main security officer to watch over the ship. They are television moniters on the walls that he used to observe the rooms on the ship.

>x moniters
The moniters are showing the command room. You can see yourself as you stare at the moniters, you also notice a book you didn't notice before behind the security officer's desk.

* * *

>give sandwich to astronaut
The astronaut gratefully accepts the sandwich, and begins eating. He finishes the sandwich in just a few seconds.

>give sandwich to astronaut
(first taking the sandwich)
That seems to belong to the Astronaut.

>talk to astronaut
Thank you so much. I thought I was going to starve for a second. I guess I owe you a spacesuit. Here you go. 
He gives you his space suit.

* * *

>talk to astronaut
I'm so hungry! Please, just give me some food. I would do anything, even give you my spacesuit if you just brought me some food.

>jump
You jump on the spot, fruitlessly.

>jump to astronaut
I only understood you as far as wanting to jump.

* * *

>talk to astronaut
I'm so hungry! Please, just give me some food. I would do anything, even give you my spacesuit if you just brought me some food.

>ask astronaut about ship
There is no reply.

* * *

>speak to astronaut
I didn't understand that sentence.

>converse with astronaut
That's not a verb I recognise.

>ask astronaut
(for the Astronaut)
(The Astronaut first taking the Astronaut)
The Astronaut has better things to do.

>n
kitchen
The room where the head chef aboard the ship would prepare all of the meals for the crew members. It appears that most of the food and supplies have been taken by the crew members who left on the escape pods. You can see the refrigerator where the chef would keep all of his ingredients.

>x fridge
A large white fridge for the head chef to keep food from spoiling on board the ship.

>open fridge
You open the refrigerator, revealing a sandwich.

* * *

>look under bed
You find the ship maintenance textbook you had been reading before bed.

>take textbook
Taken.

>w
Maintenance Room
The room that holds the engine of the space ship. The lights are flashing red, giving the impression that something might have wrong.

You can see an Engine here.

>open textbook
You don't have a maintenance problem that needs solving, so there's reason to search up something in the textbook.

>x engine
A standard UNSA spaceship engine. It takes up most of the room due to its size. There is a large "United Nations Space Association" sticker placed on the center of the engine. Upon further examining the engine, you can see that the nitrogen compressor is broken.