The ringing of your alarm clock wakes you up. You get out of bed to find that none of your fellow crew members are in the crew's quarters. They probably just went to breakfast. You had hoped for a cushy engineering job on Earth, but the UNSA had other plans for your career. It's been two years since you were assigned to this ship, and your team hasn't been able to find any sign of alien life in the cosmos. As you change from your pajamas into your uniform, you hear a loud voice booming from the intercom.

Houston, We Have a Problem
An Interactive Fiction by Leo Kodish
Release 1 / Serial number 140307 / Inform 7 build 6G60 (I6/v6.32 lib 6/12N) SD

Crew's Quarters
This is the room you have shared with your fellow astronauts for the last two years. The room is large enough to fit the twenty or so beds needed to accomodate all of the astronauts on the ship. You don't have a bedside desk or anything like that, so you've had to keep your reading material under your bed. The Maintenance Room is to your west.

>look under bd
You can't see any such thing.

* * *

>w
Maintenance Room
The room that holds the engine of the space ship. The lights are flashing red, giving the impression that something might have gone wrong. The Crew's Quarters are to the East. The Mess Hall is to the North, and the Observation Deck is to the West.

ATTENTION! This is a emergency UNSA brodcast. Most of your crewmates have safely evacuated the ship on escape pods, but if anyone is still aboard this ship, your engine has malfunctioned, and will explode unless it is fixed. We have sent a rescue team to save any crew members who may still be aboard the ship, but we predict the engine to explode before we can reach you, so you must fix the engine in order to give us enough time to save you.

I beg your pardon?

>n
Mess Hall
This is the room where the astronauts eat their meals. There are long table for eating, similar to what you would see in a school cafeteria. It's around breakfast time, so this room should be bustling with hungry crew members, but they've all left the ship. You thought you were the only person left on the ship, but you see a very hungry looking astronaut sitting down at one of the tables.

The astronaut is clutching his stomach. You can here it growling all the way from where you're standing. He's wearing a spacesuit, which would allow him to go outside of the ship if he wanted to.

>n
Kitchen
The room where the head chef aboard the ship would prepare all of the meals for the crew members. It appears that most of the food and supplies have been taken by the crew members who left on the escape pods. You can see the refrigerator where the chef would keep all of his ingredients.

>open fridge
You open the refrigerator, revealing a sandwich.

* * *

>take sandwich
Taken.

>give sandwich to astronaut
You can't see any such thing.

>give sandwich to astronaut
You can't see any such thing.

>s
Mess Hall
This is the room where the astronauts eat their meals. There are long table for eating, similar to what you would see in a school cafeteria. It's around breakfast time, so this room should be bustling with hungry crew members, but they've all left the ship. You thought you were the only person left on the ship, but you see a very hungry looking astronaut sitting down at one of the tables.

The astronaut is clutching his stomach. You can here it growling all the way from where you're standing. He's wearing a spacesuit, which would allow him to go outside of the ship if he wanted to.

>give sandwich to astronaut
The astronaut gratefully accepts the sandwich, and begins eating. He finishes the sandwich in just a few seconds.

* * *

>take space suit
Taken.

>s
Maintenance Room
The room that holds the engine of the space ship. The lights are flashing red, giving the impression that something might have gone wrong.

>w
Observation Deck
This is a room in the ship where people go to relax. It has some comfortable sofas for people to sit on, and they face a large plate of glass that acts as a window. If you look through the window, you can see the wing of the spaceship, as well as the infinite cosmos you have been traveled through for the last two years.

* * *

>w
Medical Bay
A room that is used to treat any injuries that the astronauts may have on the ship. You see a storage locker used to hold chemicals and medical equipment. Most of the equipment in the room appears to have been taken by the evacuated crew members, but there still might be something in the storage locker.

>w
You can't go that way.

>open storage locker
It appears that the most of the medicine and equipment has been taken, but you can see a scalpel and medical tubing that have been left behind.

>take medical tubing
Taken.

>take scalpel
Taken.

>combine medical tubing with space suit
You plug the medical tubing into the oxygen hole on your space suit. The suit is now tubed, capable of allowing air to flow through it, provided that it is hooked up to an oxygen tank.

>x tubed space suit
It is a space suit hooked up to medical tubing, so it is now capable of allowing air to flow through it, as long as its tube is attached to an oxygen tank.

* * *

>w
Observation Deck
This is a room in the ship where people go to relax. It has some comfortable sofas for people to sit on, and they face a large plate of glass that acts as a window. If you look through the window, you can see the wing of the spaceship, as well as the infinite cosmos you have been traveled through for the last two years. The Medical Bay is to the West. The Command Room is to the South, and the Maintenance Room is to the East.

>w
Medical Bay
A room that is used to treat any injuries that the astronauts may have on the ship. You see a storage locker used to hold chemicals and medical equipment. Most of the equipment in the room appears to have been taken by the evacuated crew members, but there still might be something in the storage locker. The Observation Deck is ot the East.

>e
Observation Deck
This is a room in the ship where people go to relax. It has some comfortable sofas for people to sit on, and they face a large plate of glass that acts as a window. If you look through the window, you can see the wing of the spaceship, as well as the infinite cosmos you have been traveled through for the last two years. The Medical Bay is to the West. The Command Room is to the South, and the Maintenance Room is to the East.

>s
Command Room
It is a room that was used by the main security officer to watch over the ship. They are television moniters on the walls that he used to observe the rooms on the ship You can also see the desk the officer would sit in to observe the moniters. The Observation Deck is to the North.

>x desk
a desk that the security officer would sit in while he observed the moniters. It has a drawer that the officer could put things in.

* * *

>open drawer
It doesn't look like the security officer kept much in here, but you do see a roll of duct tape in the drawer.

>take tape
Taken.

>x moniters
The moniters are showing the command room. You can see yourself as you stare at the moniters, you also notice a book you didn't notice before behind the security officer's desk.

>take book
You can't see any such thing.

* * *

>w
Observation Deck
This is a room in the ship where people go to relax. It has some comfortable sofas for people to sit on, and they face a large plate of glass that acts as a window. If you look through the window, you can see the wing of the spaceship, as well as the infinite cosmos you have been traveled through for the last two years. The Medical Bay is to the West. The Command Room is to the South, and the Maintenance Room is to the East.

>x window
You look through the window, staring out at the thousands of stars your ship passes by. You can see the wing of the spaceship, and you see an antenna planted on the wing.

>n
Airlock
This is the Airlock. The room where the astronauts on the ship must go through in order to enter space. The airlock door to the North leads to the wing of the spaceship.

You can see a large oxygen tank that you can hook up to your spacesuit using a tube to transfer air into your suit while out in space.

>n
You open the airlock door and step out into space, but you suffocate without any oxygen to breath.

    *** You have died ***

Would you like to RESTART, RESTORE a saved game, QUIT or UNDO the last command?

* * *

>w
Observation Deck
This is a room in the ship where people go to relax. It has some comfortable sofas for people to sit on, and they face a large plate of glass that acts as a window. If you look through the window, you can see the wing of the spaceship, as well as the infinite cosmos you have been traveled through for the last two years. The Medical Bay is to the West. The Command Room is to the South, and the Maintenance Room is to the East.

>s
Command Room
It is a room that was used by the main security officer to watch over the ship. They are television moniters on the walls that he used to observe the rooms on the ship You can also see the desk the officer would sit in to observe the moniters. The Observation Deck is to the North.

>x moniters
The moniters are showing the command room. You can see yourself as you stare at the moniters, you also notice a book you didn't notice before behind the security officer's desk.

The moniters are showing the command room. You can see yourself as you stare at the moniters, you also notice a book you didn't notice before behind the security officer's desk.

>l
Command Room
It is a room that was used by the main security officer to watch over the ship. They are television moniters on the walls that he used to observe the rooms on the ship You can also see the desk the officer would sit in to observe the moniters. The Observation Deck is to the North.

You can see a Security Handbook here.

>take book
You can't see any such thing.

>take handbook
Taken.

>inv
You are carrying:
  a Security Handbook

>open handbook
You flip to a page about lockpicking, and see that a scalpel can be used to unlock a locked door if you aren't in possesion of a lockpick.

* * *

>x moniters
The moniters are showing the command room. You can see yourself as you stare at the moniters, you also notice a book you didn't notice before behind the security officer's desk.

The moniters are showing the command room. You can see yourself as you stare at the moniters, you also notice a book you didn't notice before behind the security officer's desk.

>ee
That's not a verb I recognise.

>e
You can't go that way.

I beg your pardon?

I beg your pardon?

>e
You can't go that way.

>e
You can't go that way.

>n
Observation Deck
This is a room in the ship where people go to relax. It has some comfortable sofas for people to sit on, and they face a large plate of glass that acts as a window. If you look through the window, you can see the wing of the spaceship, as well as the infinite cosmos you have been traveled through for the last two years. The Medical Bay is to the West. The Command Room is to the South, and the Maintenance Room is to the East.

>e
Maintenance Room
The room that holds the engine of the space ship. The lights are flashing red, giving the impression that something might have gone wrong. The Crew's Quarters are to the East. The Mess Hall is to the North, and the Observation Deck is to the West.

>e
Crew's Quarters
This is the room you have shared with your fellow astronauts for the last two years. The room is large enough to fit the twenty or so beds needed to accomodate all of the astronauts on the ship. You don't have a bedside desk or anything like that, so you've had to keep your reading material under your bed. The Maintenance Room is to your west.

>look under bed
You find the ship maintenance textbook you had been reading before bed.

>take book
You can't see any such thing.

>open book
You can't see any such thing.

>take book
You can't see any such thing.

* * *

>x moniters
The moniters are showing the command room. You can see yourself as you stare at the moniters, you also notice a book you didn't notice before behind the security officer's desk.

The moniters are showing the command room. You can see yourself as you stare at the moniters, you also notice a book you didn't notice before behind the security officer's desk.

>x book
A textbook on basic security. The security officer must read this in his spare time.

>take book
Taken.

>n
Observation Deck
This is a room in the ship where people go to relax. It has some comfortable sofas for people to sit on, and they face a large plate of glass that acts as a window. If you look through the window, you can see the wing of the spaceship, as well as the infinite cosmos you have been traveled through for the last two years. The Medical Bay is to the West. The Command Room is to the South, and the Maintenance Room is to the East.

>w
Medical Bay
A room that is used to treat any injuries that the astronauts may have on the ship. You see a storage locker used to hold chemicals and medical equipment. Most of the equipment in the room appears to have been taken by the evacuated crew members, but there still might be something in the storage locker. The Observation Deck is ot the East.

>open locker
It appears that the most of the medicine and equipment has been taken, but you can see a scalpel and medical tubing that have been left behind.

* * *

>take scalpel
Taken.

>e
Observation Deck
This is a room in the ship where people go to relax. It has some comfortable sofas for people to sit on, and they face a large plate of glass that acts as a window. If you look through the window, you can see the wing of the spaceship, as well as the infinite cosmos you have been traveled through for the last two years. The Medical Bay is to the West. The Command Room is to the South, and the Maintenance Room is to the East.

>e
Maintenance Room
The room that holds the engine of the space ship. The lights are flashing red, giving the impression that something might have gone wrong. The Crew's Quarters are to the East. The Mess Hall is to the North, and the Observation Deck is to the West.

>n
Mess Hall
This is the room where the astronauts eat their meals. There are long table for eating, similar to what you would see in a school cafeteria. It's around breakfast time, so this room should be bustling with hungry crew members, but they've all left the ship. You thought you were the only person left on the ship, but you see a very hungry looking astronaut sitting down at one of the tables. The Kitchen is to the North

The astronaut is clutching his stomach. You can here it growling all the way from where you're standing. He's wearing a spacesuit, which would allow him to go outside of the ship if he wanted to.

You can also see a kitchen door here.

>unlock kitchen door
What do you want to unlock the kitchen door with?

>scalpel
You unlock the kitchen door.

>n
(first opening the kitchen door)

Kitchen
The room where the head chef aboard the ship would prepare all of the meals for the crew members. It appears that most of the food and supplies have been taken by the crew members who left on the escape pods. You can see the refrigerator where the chef would keep all of his ingredients. The Mess Hall is to the South.

You can see a kitchen door here.

* * *

>b
That's not a verb I recognise.

I beg your pardon?

* * *

>n
Mess Hall
This is the room where the astronauts eat their meals. There are long table for eating, similar to what you would see in a school cafeteria. It's around breakfast time, so this room should be bustling with hungry crew members, but they've all left the ship. You thought you were the only person left on the ship, but you see a very hungry looking astronaut sitting down at one of the tables. The Kitchen is to the North

The astronaut is clutching his stomach. You can here it growling all the way from where you're standing. He's wearing a spacesuit, which would allow him to go outside of the ship if he wanted to.

You can also see a kitchen door here.

>n
(first opening the kitchen door)
It seems to be locked.

>n
(first opening the kitchen door)
It seems to be locked.

>s
Maintenance Room
The room that holds the engine of the space ship. The lights are flashing red, giving the impression that something might have gone wrong. The Crew's Quarters are to the East. The Mess Hall is to the North, and the Observation Deck is to the West.

>w
Observation Deck
This is a room in the ship where people go to relax. It has some comfortable sofas for people to sit on, and they face a large plate of glass that acts as a window. If you look through the window, you can see the wing of the spaceship, as well as the infinite cosmos you have been traveled through for the last two years. The Medical Bay is to the West. The Command Room is to the South, and the Maintenance Room is to the East.

* * *

>x moniters
The moniters are showing the command room. You can see yourself as you stare at the moniters, you also notice a book you didn't notice before behind the security officer's desk.

The moniters are showing the command room. You can see yourself as you stare at the moniters, you also notice a book you didn't notice before behind the security officer's desk.

>take book
You can't see any such thing.

>x book
You can't see any such thing.

* * *

>n
(first opening the kitchen door)
It seems to be locked.

>open fridge
You open the refrigerator, revealing a sandwich.

* * *

>take sandwich
Taken.

>s
Mess Hall
This is the room where the astronauts eat their meals. There are long table for eating, similar to what you would see in a school cafeteria. It's around breakfast time, so this room should be bustling with hungry crew members, but they've all left the ship. You thought you were the only person left on the ship, but you see a very hungry looking astronaut sitting down at one of the tables.

The astronaut is clutching his stomach. You can here it growling all the way from where you're standing. He's wearing a spacesuit, which would allow him to go outside of the ship if he wanted to.

>give sandwich to astronat
You can't see any such thing.

>give sandwich to astronaut
The astronaut gratefully accepts the sandwich, and begins eating. He finishes the sandwich in just a few seconds.

* * *

>open locker
It appears that the most of the medicine and equipment has been taken, but you can see a scalpel and medical tubing that have been left behind.

>take medical tubing
Taken.

>combine medical tubing with space suit
You plug the medical tubing into the oxygen hole on your space suit. The suit is now tubed, capable of allowing air to flow through it, provided that it is hooked up to an oxygen tank.

>inv
You are carrying:
  a tubed space suit

>x tubed space suit
You see nothing special about the tubed space suit.

* * *

>look under bed
You find the ship maintenance textbook you had been reading before bed.

>take book
Taken.

* * *

>look under bde
You can't see any such thing.

* * *

>x bed
A folding bed with an old mattress on it. It's similar to a standard military bed, with a metal headboard and bed frame.